0	nula	01 Zahlen decz
1	{\color{blue}jeden},{\color{red}jedna},{\color{green}jedno}	01 decz
2	{\color{blue}dva},{\color{red}dv{\v{e}}},{\color{green}dv{\v{e}}}	01 Zahlen decz
3	t\v{r}i	01 Zahlen decz
4	\v{c}ty\v{r}i	01 Zahlen decz
5	p\v{e}t	01 Zahlen decz
6	\v{s}est	01 Zahlen decz
7	sedm	01 Zahlen decz
8	osm	01 Zahlen decz
9	dev\v{e}t	01 Zahlen decz
10	deset	01 Zahlen decz
Wie viel kostet $x$ ?	Kolik stoj\'i $x$ ?	01 Zahlen decz
Wie viel ist 9 minus 8?	Kolik je dev\v{e}t minus osm?	01 Zahlen decz
Wie viel kostet das ?	Kolik to stoj\'i ?	01 Zahlen decz
Wie viel ist 15 + 4 ?	Kolik je patn\'act plus \v{c}ty\v{r}i ?	01 Zahlen decz
11	jeden\'act	01 Zahlen decz
12	dvan\'act	01 Zahlen decz
13	t\v{r}in\'act	01 Zahlen decz
14	\v{c}trn\'act	01 Zahlen decz
15	patn\'act	01 Zahlen decz
16	\v{s}estn\'act	01 Zahlen decz
17	sedmn\'act	01 Zahlen decz
18	osmn\'act	01 Zahlen decz
19	devaten\'act	01 Zahlen decz
20	dvacet	01 Zahlen decz
ich	j\'a	01 Personalpronomen decz
du	ty	01 Personalpronomen decz
er	on	01 Personalpronomen decz
sie (Singular)	ona	01 Personalpronomen decz
es	ono	01 Personalpronomen decz
wir	my	01 Personalpronomen decz
ihr	vy	01 Personalpronomen decz
Sie (Anrede)	vy (in: Anrede)	01 Personalpronomen decz
sie (3. Plural)	oni	01 Personalpronomen decz
ich bin	j\'a jsem	01 Verben decz
du bist	ty jsi (umg.) / ty jse\v{s}	01 Verben decz
sie ist	ona je	01 Verben decz
wir sind	my jsme	01 Verben decz
ihr seid	vy jste	01 Verben decz
Sie sind (Anrede)	vy jste (+Anrede)	01 Verben decz
sie sind	oni jsou	01 Verben decz
tsch\"u\ss, hallo	ahoj / \v{c}au	01 Konversation decz
Wie hei\ss t du?	Jak se jmenuje\v{s}?	01 Konversation decz
guten Tag	dobr\'y den	01 Konversation decz
Woher kommst du?	Odkud jsi?	01 Konversation decz
Ich bin aus Deutschland	(J\'a) jsem z N\v{e}mecka	01 Konversation decz
Was machst du?	Co d\v{e}l\'a\v{s}?	01 Konversation decz
danke	d\'iky (umg.) / d\v{e}kuju / d\v{e}kuji	01 Konversation decz
Entschuldigung! (du/Sie)	Promi{\v{n}}! Promi{\v{n}}te!	01 Konversation decz
Mach es gut	M\v{e}j se hezky	01 Konversation decz
du auch	ty taky	01 Konversation decz
Auf Wiedersehen.	Na shledanou.	01 Konversation decz
Wo wohnst du?	Kde bydl\'i\v{s}?	01 Konversation decz
Ich wohne in $x$.	J\'a bydlim v $x$.	01 Konversation decz
Entschuldige ich bin zu sp\"at.	Promi\v{n} jdu pozd\v{e}.	01 Konversation decz
{\color{blue}cukr}	Zucker	01 Index Lebensmittel
Zigarette	cigareta	01 Lebensmittel decz
Zitrone	{\color{blue}citron}	01 Index Lebensmittel decz
30	t\v{r}icet	01 Zahlen decz
40	\v{c}ty\v{r}icet	01 Zahlen decz
50	pades\'{a}t	01 Zahlen decz
60	\v{s}edes\'{a}t	01 Zahlen decz
70	sedmdes\'{a}t	01 Zahlen decz
80	osmdes\'{a}t	01 Zahlen decz
90	devades\'{a}t	01 Zahlen decz
100	sto	01 Zahlen decz
{\color{cyan}amat{\'e}r}	Amateur	01 Index
{\color{red}ambas{\'a}da}	Botschaft (i.S.v. Diplomatie)	01 Index
{\color{green}auto}	Auto	01 Index
{\color{blue}autobus}	Bus	01 Index
{\color{blue}balet}	Ballet	01 Index
{\color{blue}ban{\'a}n}	Banane	01 Index
{\color{red}banka}	Bank	01 Index
{\color{blue}bar}	Bar	01 Index
{\color{red}brokolice}	Brokkoli	01 Index
{\color{blue}{\v{c}}aj}	Tee	01 Index
{\color{red}demokracie}	Demokratie	01 Index
{\color{red}diskot{\'e}ka}	Diskothek	01 Index
{\color{blue}dort}	Torte	01 Index
{\color{cyan}d{\v{z}}entlmen}	Gentleman	01 Index
{\color{red}ekonomika}	Wirtschaft	01 Index
fajn	toll, super	01 Index
{\color{cyan}gangster}	Gangster	01 Index
{\color{red}gorila}	Gorilla	01 Index
{\color{blue}chaos}	Chaos	01 Index
{\color{blue}chl{\'e}b }(formal)	Brot (formal)	01 Index
{\color{blue}chleba}	Brot	01 Index
{\color{red}informace}	Information	01 Index
j{\'a}	ich	01 Index
{\color{green}jablko}	Apfel	01 Index
{\color{green}j{\'{\i}}dlo}	Essen, Gericht	01 Index
{\color{green}kafe} (coll.)	Kaffee (coll.)	01 Index
{\color{green}kakao}	Kakao	01 Index
{\color{red}k{\'a}va}	Kaffee (nicht coll.)	01 Index
{\color{red}kav{\'a}rna}	Caf{\'e}	01 Index
{\color{blue}ke{\v{c}}up}	Ketchup	01 Index
{\color{green}kino}	Kino	01 Index
{\color{blue}knedl{\'{\i}}k}, {\color{blue} knedl{\'{\i}}ky}	Kn{\"o}del	01 Index
{\color{red}komedie}	Kom{\"o}die	01 Index
To je {\color{red}komplikace}	Das ist kompliziert(?) // Komplikation/Verwicklung(?)	01 Index
{\color{red}konference}	Konferenz	01 Index
{\color{blue}konflikt}	Konflikt	01 Index
{\color{blue}kontakt}	Kontakt	01 Index
{\color{red}majon{\'e}za}	Mayonnaise	01 Index
{\color{green}m{\'a}slo}	Butter	01 Index
{\color{green}maso}	Fleisch	01 Index
M{\v{e}} taky!	Mich auch!	01 Index
{\color{green}metro}	Metro, U-Bahn	01 Index
{\color{red}miner{\'a}lka}	Mineralwasser	01 Index
{\color{blue}m{\'{\i}}tink}	Besprechung, Meeting	01 Index
{\color{green}ml{\'e}ko}	Milch	01 Index
{\color{blue}nesmysl}	Unsinn	01 Index
{\color{red}okurka}	Gurke	01 Index
{\color{red}opera}	Oper	01 Index
{\color{green}ovoce}	Obst	01 Index
{\color{blue}park}	Park	01 Index
{\color{green}parkovi{\v{s}}t{\v{e}}}	Parkplatz	01 Index
{\color{green}pit{\'{\i}}}	Getr{\"a}nk, Trinken	01 Index
{\color{green}pivo}	Bier	01 Index
{\color{blue}pl{\'a}t\uline{e}k}	Scheibe (K{\"a}se, Wurst)	01 Index
{\color{red}policie}	Polizei	01 Index
{\color{red}politi{\v{c}}ka}	Politikerin	01 Index
{\color{cyan}politik}	Politiker	01 Index
{\color{red}politika}	Politik	01 Index
{\color{red}po{\v{s}}ta}	Post(amt)	01 Index
{\color{red}pravda}	Wahrheit	01 Index
{\color{cyan}prezident}	Pr{\"a}sident	01 Index
{\color{red}prezidentka}	Pr{\"a}sidentin	01 Index
{\color{blue}probl{\'e}m}	Problem	01 Index
{\color{cyan}profesion{\'a}l}	Experte	01 Index
{\color{red}profesion{\'a}lka}	Expertin	01 Index
{\color{red}provokace}	Provokation	01 Index
{\color{red}pumpa}	Tankstelle	01 Index
{\color{green}r{\'a}dio}	Radio	01 Index
{\color{red}restaurace}	Restaurant	01 Index
{\color{green}rodeo}	Rodeo	01 Index
{\color{blue}rohl{\'{\i}}k}	H{\"o}rnchen	01 Index
rozum{\v{e}}t, rozum{\'{\i}}m (impf.)	verstehen (impf.)	01 Index Verben
{\color{blue}skand{\'a}l}	Skandal	01 Index
{\color{cyan}student}	1. (Gynmasial)Sch{\"u}ler, 2. Student	01 Index
{\color{red}studentka}	1. (Gynmasial)Sch{\"u}lerin, 2. Studentin	01 Index
{\color{blue}supermarket}	Supermarkt	01 Index
{\color{blue}s{\'y}r}	K{\"a}se	01 Index
{\v{s}}koda	schade	01 Index
{\color{blue}{\v{s}}ok}	Schock	01 Index
taky	auch	01 Index
{\color{blue}tax{\'{\i}}k}	Taxi	01 Index
T{\v{e}}{\v{s}}{\'{\i}} m{\v{e}}!	Es freut mich, Sie kennen zu lernen!	01 Index
{\color{red}toaleta}	Toilette/WC (Fremdwort)	01 Index
{\color{red}tramvaj}	Stra{\ss}enbahn	01 Index
{\color{blue}tr{\'e}nink}	Training	01 Index
{\color{cyan}turista}	Tourist	01 Index
{\color{red}turistka}	Touristin	01 Index
ty	du	01 Index
v po{\v{r}}{\'a}dku	o.k., in Ordnung	01 Index
{\color{green}v{\'{\i}}no}	Wein	01 Index
To je v{\v{s}}echno.	Das ist alles.	01 Index
{\color{blue}vtip}	Witz	01 Index
{\color{red}zelenina}	Gem{\"u}se	01 Index
{\color{red}zmrzlina}	Eiscreme	01 Index
Jak se \v{r}ekne \v{c}esky x?	Wie sagt man auf Tschechisch x?	01 Konversation
Co znamen{\'a} x?	Was bedeutet x?	01 Konversation
Je{\v{s}}t{\v{e}} jednou, pros\'{\i}m.	Noch einmal, bitte.	01 Konversation
{\color{blue}hotel}	Hotel	01
{\color{blue}hostel}	Hostel	01
Jak se m{\'a}{\v{s}}? / Jak se m{\'a}te?	Wie geht es Dir? / Wie geht es Ihnen?	01 Konversation
dob{\v{r}}e / Ujde to. / {\v{s}}patn{\v{e}}	gut / Es geht so. / schlecht	01 Konversation
nen{\'{\i}}	(er/sie/es) ist nicht	01
Verneinung des Verbs	jsem -- nejsem ...	01 Verben decz grammatik
To je {\color{red}tragedie}.	Das ist tragisch.	01 Konversation
To je jedno.	Das ist egal.	01 Konversation
dv{\v{e}} st{\v{e}}	200	01 Zahlen
t\v{r}i sta	300	01 Zahlen
\v{c}ty\v{r}i sta	400	01 Zahlen
p\v{e}t set	500	01 Zahlen
\v{s}est set	600	01 Zahlen
sedm set	700	01 Zahlen
osm set	800	01 Zahlen
dev\v{e}t set	900	01 Zahlen
tis{\'{\i}}c	1000	01 Zahlen
dva tis{\'{\i}}ce	2000	01 Zahlen
t\v{r}i tis{\'{\i}}ce	3000	01 Zahlen
\v{c}ty\v{r}i tis{\'{\i}}ce	4000	01 Zahlen
p\v{e}t tis{\'{\i}}c	5000	01 Zahlen
\v{s}est tis{\'{\i}}c	6000	01 Zahlen
sedm tis{\'{\i}}c	7000	01 Zahlen
osm tis{\'{\i}}c	8000	01 Zahlen
dev\v{e}t tis{\'{\i}}c	9000	01 Zahlen
jeden milion	1 000 000	01 Zahlen
dva miliony	2 000 000	01 Zahlen
t\v{r}i miliony	3 000 000	01 Zahlen
\v{c}ty\v{r}i miliony	4 000 000	01 Zahlen
p\v{e}t milion{\accent'27u}	5 000 000	01 Zahlen
\v{s}est milion{\accent'27u}	6 000 000	01 Zahlen
sedm milion{\accent'27u}	7 000 000	01 Zahlen
osm milion{\accent'27u}	8 000 000	01 Zahlen
dev\v{e}t milion{\accent'27u}	9 000 000	01 Zahlen
a	und	01 Index
ale	aber	02 Index
{\color{red}Amerika}, {\color{cyan}Ameri{\v{c}}an}, {\color{red}Ameri{\v{c}}anka}	Amerika, Amerikaner, Amerikanerin	02 Index
{\color{red}Anglie}, {\color{cyan}Angli{\v{c}}an}, {\color{red}Angli{\v{c}}anka}	England, Engl{\"a}nder, Engl{\"a}nderin	02 Index
asi	wahrscheinlich, wohl (adv.)	02 Index
{\color{red}babi{\v{c}}ka}	Gro{\ss}mutter	02 Index
{\color{blue}batoh}	Rucksack (ohne Fremdwort)	02 Index
b{\'{\i}}l{\'y}	wei{\ss} (adj.)	02 Index adj
bohat{\'y}	reich (adj.)	02 Index adj
{\color{cyan}bratr}	Bruder	02 Index
bu{d'}(to) -- nebo	entweder -- oder	02 Index
b{\'y}t, jsem (impf.)	sein, ich bin (impf.)	03 03b Index Verben unregelmaessig
cestovat, cestuju (impf.)	reisen (impf.)	03 03b Index Verben
cestovn{\'{\i}} {\color{red}kancel{\'a}{\v{r}}}	Reiseb{\"u}ro	03 03b Index
citronov{\'y} (adj.)	Zitronen-	01 Index adj
co	1. was (Fragepronomen) 2. (coll.) welcher, welche, welches	02 Index
{\v{c}}ern{\'y}	schwarz	02 Index adj
{\v{c}}erven{\'y}	rot (adj.)	02 Index adj
{\v{C}}esk{\'a} {\color{red}republika}	Tschechische Republik	02 Index
{\v{c}}esk{\'y}	1. tschechisch, 2. b{\"o}hmisch	02 Index adj
{\v{c}}{\'{\i}}	wessen	02 Index
{\v{c}}{\'{\i}}st*/ {\v{c}}tu, {\v{c}}te{\v{s}}, {\v{c}}te, {\v{c}}teme, {\v{c}}tete, {\v{c}}tou/ {\v{c}}etl/ {\v{c}}ti (impf.)	lesen (volle Konjugation, impf.)	03 03b Index Verben unregelmaessig
{\color{cyan}{\v{c}}lov{\v{e}}k}	Mensch	02 Index
{\color{blue}{\v{c}}tvrt\uline{e}k}	Donnerstag	03 Index
{\color{red}dcera} (sprich: cera)	Tochter	02 Index
{\color{cyan}d{\v{e}}de{\v{c}}\uline{e}k}	Gro{\ss}vater	02 Index
d{\v{e}}kovat, d{\v{e}}kuju (impf.)	danken (impf.)	03 03b Index Verben
d{\v{e}}lat, d{\v{e}}l{\'a}m (impf.)	tun, machen (impf.)	03 03b Index Verben
d{\v{e}}lat, d{\v{e}}l{\'a}m kari{\'e}ru (impf.)	Karriere machen (impf.)	03 03b Index Verben
{\color{blue}den}	Tag	03 Index
{\color{red}detektivka}	Detektivgeschichte	03 Index
{\color{blue}di{\'a}{\v{r}}}	Kalender, Terminkalender	02 Index
{\color{green}d{\'{\i}}t{\v{e}}}, (pl.:) {\color{green}d{\v{e}}ti}	Kind, Kinder	02 Index
d{\'{\i}}vat se na (impf.)	schauen (impf.)	03 03b Index Verben
{\color{red}d{\'{\i}}vka}	M{\"a}dchen (nicht coll.)	02 Index
dobr{\'y}	gut (adj.)	02 Index adj
{\color{cyan}doktor}, {\color{red}doktorka}	Doktor(in), Arzt/{\"A}rztin	02 Index
dole	unten	03 Index
{\color{green}dopoledne}	am Vormittag	03 Index
drah{\'y}	1. teuer (adj.) 2. mein Teurer	02 Index adj
{\color{blue}d{\accent'27u}m}, domy	Haus, H{\"a}user	02 Index
elegantn{\'{\i}}	elegant (adj.)	02 Index adj
energick{\'y}	lebhaft (z.B. Person)	02 Index adj
{\color{cyan}herec}	Schauspieler	02 Index
{\color{red}here{\v{c}}ka}	Schauspielerin	02 Index
hezk{\'y}	sch{\"o}n, h{\"u}bsch (adj.)	02 Index adj
{\color{red}hodina}	Stunde	03 Index
{\color{red}hodiny} (pl.)	Uhr	03 Index
{\color{red}holka} (coll.)	M{\"a}del (coll.)	02 Index
hork{\'y}	hei{\ss} (adj.)	02 Index adj
hr{\'a}t si, hraju si s (impf.)	mit jmdm. spielen (impf.)	03 03b Index Verben unregelmaessig
hrát* / hraju, hraješ, hraje, hrajeme, hrajete, hrajou / hrál / hraj (impf.)	spielen (Rolle, Instrument, Sport, Glücksspiel) (impf.)	03 03b Index Verben unregelmaessig
{\color{blue}hrnek}	Becher, Pott, Tasse (Keramik)	02 Index
huben{\'y}	d{\"u}nn, abgemagert (adj.)	02 Index adj
{\color{cyan}chlap\uline{e}c}	Junge	02 Index
chodit, chod{\'{\i}}m na v{\'y}lety	Ausfl{\"u}ge machen	03 03b Index Verben
chodit, chod{\'{\i}}m s	mit jmdm. gehen	03 03b Index Verben
chud{\'y}	arm (adj.)	02 Index adj
chytr{\'y}	gescheit, clever	02 Index adj
ide{\'a}ln{\'{\i}}	ideal, perfekt	02 Index adj
inteligentn{\'{\i}}	intelligent	02 Index adj
jak	wie; (coll.) welcher, welche, welches (adv.-Fragewort)	02 Index
jako	wie (z.B. wie ich)	02 Index
jak{\'y}	was f{\"u}r ein (adj.-Fragewort)	02 Index adj
{\color{green}jaro}	Fr{\"u}hling	03 Index
Jdi dom{\accent'27u}! Jd{\v{e}}te dom{\accent'27u}!	Geh/geht nach Hause!	03 Index
jeho	sein (possesiv)	02 Index
jej{\'{\i}}	ihr (possesiv, 3. P. Sg.)	02 Index
jejich	ihr (possesiv, 3. P. Pl.)	02 Index
jet*, jedu metrem (impf.)	mit der Metro fahren (impf.)	03 03b Index Verben unregelmaessig
jet*, jedu (autem, vlakem...) (impf.)	(mit dem Auto, Zug...) fahren (impf.)	03 03b Index Verben unregelmaessig
jet* / jedu, jedeš, jede, jedeme, jedete, jedou / jel / jed' (impf.)	fahren (impf.)	03 03b Index Verben unregelmaessig
jezdit -- jet* na jacht{\v{e}}	auf einer Yacht segeln, fahren	03 03b Index Verben unregelmaessig
jezdit -- jet* na kole	Fahrrad fahren	03 03b Index Verben unregelmaessig
jezdit -- jet* na kole{\v{c}}kov{\'y}ch brusl{\'{\i}}ch	Inline skates fahren	03 03b Index Verben unregelmaessig
jezdit -- jet* na lodi	Boot fahren	03 03b Index Verben unregelmaessig
jezdit -- jet* na skatebordu (na skejtu)	Skateboard fahren	03 03b Index Verben unregelmaessig
jít* / jdu, jdeš, jde, jdeme, jdete, jdou / šel, šla, šli / jdi (impf.)	gehen (impf.)	03 03b Index Verben unregelmaessig
jmenovat se, jmenuju se (impf.)	hei{\ss}en (impf.)	03 03b Index Verben
{\color{cyan}kamar{\'a}d}, {\color{red}kamar{\'a}dka}	Freund (Fremdwort)	02 Index
kdo	wer (Fragepronomen)	02 Index
kdy	wann	03 Index
kdy{\v{z}}	1. wenn 2. falls	03 Index
{\color{cyan}kluk} (coll.)	Junge (coll.)	02 Index
{\color{red}kniha}, knihy	Buch, B{\"u}cher	02 Index
{\color{cyan}kolega}, {\color{red}kolegyn{\v{e}}}	Kollege, Kollegin	02 Index
kolik	wie viel (adv.-Fragewort)	02 Index
{\color{blue}koncert}	Konzert	03 Index
kr{\'a}sn{\'y}	sch{\"o}n (adj.)	02 Index adj
kvalitn{\'{\i}}	von guter Qualit{\"a}t	02 Index adj
{\color{red}l{\'a}ska}	Liebe	02 Index
{\color{red}lekce}	Lektion	03 Index
{\color{green}l{\'e}to}	Sommer	03 Index
levn{\'y}	preiswert, billig (adj.)	02 Index adj
{\color{cyan}lid{\'e}}	Leute	02 Index
{\color{cyan}lidi} (coll.)	Leute (coll.)	02 Index
ly{\v{z}}ovat, ly{\v{z}}uju (impf.)	Ski laufen (impf.)	03 03b Index Verben
malovat, maluju (impf.)	malen (impf.)	03 03b Index Verben
mal{\'y}	klein (adj.)	02 Index adj
{\color{red}maminka}	Mutti, Mama	02 Index
{\color{cyan}mana{\v{z}}er}, {\color{red}mana{\v{z}}erka}	Manager, Managerin	02 Index
{\color{cyan}man{\v{z}}el}	Ehemann	02 Index
{\color{red}man{\v{z}}elka}	Ehefrau	02 Index
{\color{red}matka}	Mutter	02 Index
M{\v{e}}j se hezky! M{\v{e}}jte se hezky!	Mach's gut! Macht's gut!	01 Index
M{\v{e}}j se! M{\v{e}}jte se! (coll.)	Mach's gut! Macht's gut! (coll.)	01 Index
{\color{blue}m{\v{e}}s{\'{\i}}c}	1. Monat 2. Mond	03 Index
{\color{cyan}milion{\'a}{\v{r}}}, {\color{red}milion{\'a}{\v{r}}ka}	Million{\"a}r/in	02 Index
m{\'{\i}}t(*) n{\'a}v{\v{s}}t{\v{e}}vu (impf.)	Besuch haben (impf.)	03 03b Index Verben unregelmaessig
m{\'{\i}}t* {\v{c}}as (impf.)	Zeit haben (impf.)	03 03b Index Verben unregelmaessig
m{\'{\i}}t* dovolenou (impf.)	Urlaub haben (impf.)	03 03b Index Verben unregelmaessig
m{\'{\i}}t* {\color{blue}hlad} (impf.)	Hunger haben (impf.)	03 03b Index Verben unregelmaessig
m{\'{\i}}t* r{\'y}mu (impf.)	einen Schnupfen haben (impf.)	03 03b Index Verben unregelmaessig
m{\'{\i}}t* sch{\accent'27u}zku (impf.)	eine Verabredung haben (impf.)	03 03b Index Verben unregelmaessig
m{\'{\i}}t* sm{\accent'27u}lu (impf.)	Pech haben (impf.)	03 03b Index Verben unregelmaessig
m{\'{\i}}t* strach (impf.)	Angst haben (impf.)	03 03b Index Verben unregelmaessig
m{\'{\i}}t* svatbu	Hochzeit feiern	03 03b Index Verben unregelmaessig
m{\'{\i}}t* {\color{green}{\v{s}}t{\v{e}}st{\'{\i}} }(impf.)	Gl{\"u}ck haben	03 03b Index Verben unregelmaessig
m{\'{\i}}t* volno (impf.)	frei haben (impf.)	03 03b Index Verben unregelmaessig
m{\'{\i}}t* vztek (impf.)	w{\"u}tend sein (impf.)	03 03b Index Verben unregelmaessig
m{\'{\i}}t* {\color{red}zlost }(impf.)	Wut haben	03 03b Index Verben unregelmaessig
m{\'{\i}}t* {\color{red}{\v{z}}{\'{\i}}ze{\v{n}} }(impf.)	Durst haben	03 03b Index Verben unregelmaessig
m{\'{\i}}t*, m{\'a}m (impf.)	haben (impf.)	03 03b Index Verben unregelmaessig
m{\'{\i}}t* dobrou n{\'a}ladu (impf.)	gute Laune haben (impf.)	03 03b Index Verben unregelmaessig
m{\'{\i}}t* kr{\'a}sn{\'y} {\v{z}}ivot (impf.)	ein sch{\"o}nes Leben haben (impf.)	03 03b Index Verben unregelmaessig
m{\'{\i}}t* moc pr{\'a}ce(impf.)	viel Arbeit haben	03 03b Index Verben unregelmaessig
m{\'{\i}}t* n{\'a}pad (impf.)	eine Idee / einen Einfall haben (impf.)	03 03b Index Verben unregelmaessig
m{\'{\i}}t* narozeniny(impf.)	Geburtstag haben	03 03b Index Verben unregelmaessig
m{\'{\i}}t* pen{\'{\i}}ze (impf.)	Geld haben (impf.)	03 03b Index Verben unregelmaessig
m{\'{\i}}t* pravdu (impf.)	Recht haben (impf.)	03 03b Index Verben unregelmaessig
m{\'{\i}}t* r{\'a}d, m{\'a}m r{\'a}d (impf.)	gern haben (impf.)	03 03b Index Verben unregelmaessig
m{\'{\i}}t* rande (impf.)	ein Rendezvous haben	03 03b Index Verben unregelmaessig
mlad{\v{s}}{\'{\i}}	j{\"u}nger	02 Index
mlad{\'y}	jung	02 Index adj
mluvit, mluv{\'{\i}}m (impf.)	sprechen (impf.)	03 03b Index Verben
{\color{blue}mobil}	Handy, Mobiltelefon	02 Index
moc	1. viel, 2. sehr (adv.)	02 Index
moct*/ můžu, můžeš, může, můžeme, můžete, můžou / mohl / -- (impf.)	k{\"o}nnen (impf.)	03 03b Index Verben kann unregelmaessig
{\color{cyan}m{\accent'27u}j}, {\color{blue}m{\accent'27u}j}, {\color{red}moje/m{\'a}}, {\color{green}moje/m{\'e}}	mein, mein, meine, mein	02 Index
muset, mus{\'{\i}}m (impf.)	m{\"u}ssen (impf.)	03 03b Index Verben
{\color{cyan}mu{\v{z}}}	Mann (i.S.v. Frau)	02 Index
myslet, mysl{\'{\i}}m (impf.)	denken (impf.)	02 Index
m{\'y}t*, myju (impf.)	waschen (K{\"o}rper, Geschirr) (impf.)	03 03b Index Verben unregelmaessig
na	auf, an, in	02 Index
na ja{\v{r}}e	im Fr{\"u}hling	03 Index
na podzim	im Herbst	03 Index
nakupovat, nakupuju (impf.)	einkaufen (impf.)	03 03b Index Verben
{\color{cyan}n{\'a}{\v{s}}}, {\color{blue}n{\'a}{\v{s}}}, {\color{red}na{\v{s}}e}, {\color{green}na{\v{s}}e}	unser, unser, unsere, unser	02 Index
nebo	oder	02 Index
{\color{red}ned{\v{e}}le}	Sonntag	03 Index
nejlep{\v{s}}{\'{\i}}	der beste (adj.)	02 Index adj
n{\v{e}}kdy	irgendwann, manchmal	02 Index
{\color{green}N{\v{e}}mecko, }{\color{cyan}N{\v{e}}mec}{\color{green}, }{\color{red}N{\v{e}}mka}	Deutschland, Deutscher, Deutsche	02 Index
{\color{red}nemoc}	Krankheit	02 Index
{\color{red}nemocnice}	Krankenhaus	02 Index
nemocn{\'y}	krank (adj.)	02 Index adj
nervozn{\'{\i}}	nerv{\"o}s	02 Index adj
{\color{red}noc}	Nacht	03 Index
nov{\'y}	neu	02 Index adj
ob{\v{e}}dvat, ob{\v{e}}dv{\'a}m (impf.)	zu Mittag essen (impf.)	03 03b Index Verben
odkud	woher (Fragewort)	02 Index
odpo{\v{c}}{\'{\i}}vat, odpo{\v{c}}{\'{\i}}v{\'a}m (impf.)	sich ausruhen (impf.)	03 03b Index Verben
{\color{green}odpoledne}	nachmittag, am Nachmittag	03 Index
opravdu	wirklich (adv.)	02 Index
{\color{cyan}optimista}, {\color{red}optimistka}	Optimist/in	02 Index
optimistick{\'y}	optimistisch	02 Index adj
o{\v{s}}kliv{\'y}	h{\"a}sslich (adj.)	02 Index adj
{\color{red}ot{\'a}zka}	Frage	03 Index
{\color{cyan}ot\uline{e}c}	Vater	02 Index
{\color{cyan}pan}	Herr (vor dem Namen, i.S.v. Anrede)	02 Index
{\color{cyan}p{\'a}n}	Herr (i.S.v. Dame)	02 Index
{\color{red}{\v{z}}ena}	Frau (i.S.v. Mann)	02 Index
{\color{cyan}partner}, {\color{red}partnerka}	Partner, Partnerin	02 Index
{\color{red}party}	Party	03 Index
{\color{blue}p{\'a}t\uline{e}k}	Freitag	03 Index
{\color{cyan}pesimista}, {\color{red}pesimistka}	Pessimist/in	02 Index
pesimistick{\'y}	pessimistisch	02 Index adj
pít* / piju, piješ, pije, pijeme, pijete, pijou / pil / pij (impf.)	trinken (impf.)	03 03b Index Verben unregelmaessig
plavat* / plavu, plaveš, plave, plaveme, plavete, plavou / plaval / plav (impf.)	schwimmen (impf.)	03 03b Index Verben unregelmaessig
{\color{blue}po{\v{c}}{\'{\i}}ta{\v{c}}}	Computer	02 Index
po{\v{c}}{\'{\i}}tat, po{\v{c}}{\'{\i}}t{\'a}m (impf.)	z{\"a}hlen (impf.)	03 Index
{\color{blue}podzim}	Herbst	03 Index
{\color{green}poledne}	Mittag, am Mittag	03 Index
{\color{green}pond{\v{e}}l{\'{\i}}}	Montag	03 Index
pou{\v{z}}{\'{\i}}vat, pou{\v{z}}{\'{\i}}v{\'a}m (impf.)	verwenden, gebrauchen (impf.)	03 Index
{\color{red}prababi{\v{c}}ka}	Urgro{\ss}mutter	02 Index
pracovat, pracuju (impf.)	arbeiten (impf.)	03 03b Index Verben
pracovat, pracuju na po{\v{c}}{\'{\i}}ta{\v{c}}i (impf.)	am Computer arbeiten (impf.)	02 Index Verben
pracovit{\'y}	arbeitsam	03 03b Index adj
{\color{cyan}prad{\v{e}}de{\v{c}}\uline{e}k}	Urgro{\ss}vater	02 Index
{\color{cyan}premi{\'e}r}	Premierminister	02 Index
{\color{red}premi{\'e}rka}	Premierministerin	02 Index
{\color{cyan}profesor}	Professor	02 Index
{\color{red}profesorka}	Professorin	02 Index
proto{\v{z}}e	weil	03 Index
p{\v{r}}{\'{\i}}buzn{\'y} (adj.)	Verwandter	02 Index adj
p{\v{r}}{\'{\i}}{\v{s}}t{\'{\i}}	n{\"a}chster	03 Index
{\color{cyan}p{\v{r}}{\'{\i}}tel}	Freund (i.S.v. boyfriend)	02 Index
{\color{red}p{\v{r}}{\'{\i}}telkyn{\v{e}}}	Freundin (i.S.v. girlfriend)	02 Index
psát* / píšu, píšeš, píše, píšeme, píšete, píšou / psal / piš (impf.)	schreiben (impf.)	03 03b Index Verben unregelmaessig
{\color{red}puber{t'}a{\v{c}}ka}(pej.)	Teenager (w., pej.)	02 Index
{\color{cyan}puber{t'}{\'a}k}(pej.)	Teenager (m., pej.)	02 Index
{\color{green}r{\'a}no}	1. Morgen 2. am Morgen	03 Index
{\color{cyan}rodi{\v{c}}e}	Eltern	02 Index
{\color{red}rodina}	Familie	02 Index
{\color{blue}rok}	Jahr	03 Index
{\color{green}Rusko}, {\color{cyan}Rus}, {\color{red}Ruska}	Russland, Russe, Russin	02 Index
{\color{cyan}{\v{r}}editel}	Direktor	02 Index
{\color{red}{\v{r}}editelka}	Direktorin	02 Index
{\v{r}}{\'{\i}}kat, {\v{r}}{\'{\i}}k{\'a}m (impf.)	sagen (impf.)	03 03b Index Verben
{\color{blue}sal{\'a}t}	Salat	02 Index
{\color{cyan}sekret{\'a}{\v{r}}}	Sekret{\"a}r	02 Index
{\color{red}sekret{\'a}{\v{r}}ka}	Sekret{\"a}rin	02 Index
{\color{blue}seri{\'a}l}	Fernsehserie	03 Index
{\color{red}sestra}	Schwester	02 Index
siln{\'y}	stark (adj.)	02 Index adj
{\color{red}skleni{\v{c}}ka}	Gl{\"a}schen (i.S.v. Trinkglas)	02 Index
slab{\'y}	schwach (adj.)	02 Index adj
{\color{red}sle{\v{c}}na}	Fr{\"a}ulein (Wird im Tschechischen tats{\"a}chlich verwendet.)	02 Index
slep{\'y}	blind	02 Index adj
smutn{\'y}	traurig (adj.)	02 Index adj
sn{\'{\i}}dat, sn{\'{\i}}d{\'a}m (impf.)	fr{\"u}hst{\"u}cken (impf.)	03 03b Index Verben
{\color{red}sobota}	Samstag, Sonnabend	03 Index
sp{\'a}t*/ sp{\'{\i}}m, sp{\'{\i}}{\v{s}}, sp{\'{\i}}, sp{\'{\i}}me, sp{\'{\i}}te, sp{\'{\i}}/ spal/ spi (impf.)	schlafen (volle Konjugation, impf.)	03 03b Index Verben unregelmaessig
spole{\v{c}}n{\'y}	gemeinsamer	03 Index
spolu	gemeinsam	03 Index
{\color{cyan}sportov\uline{e}c}	Sportler	02 Index
{\color{red}sportovkyn{\v{e}}}	Sportlerin	02 Index
star{\v{s}}{\'{\i}}	{\"a}lter	02 Index
star{\'y}	alt (Gegenst{\"a}nde und Personen)	02 Index adj
stra{\v{s}}n{\v{e}}	furchtbar (adv.)	02 Index
stra{\v{s}}n{\'y}	furchtbar (adj.)	02 Index adj
{\color{cyan}strejda} (coll.)	Onkel (coll.)	02 Index
{\color{cyan}str{\'y}{\v{c}}\uline{e}k}	Onkel (z.B. innerhalb der Familie)	02 Index
{\color{red}st{\v{r}}eda}	Mittwoch	03 Index
studen{\'y} (adj.)	kalt (adj.)	02 Index adj
studovat, studuju (impf.)	1. studieren, 2. zur Schule gehen (impf.)	03 03b Index Verben
sympatick{\'y}	sympathisch	02 Index adj
{\color{cyan}syn}	Sohn	02 Index
{\color{cyan}synovec}	Neffe	02 Index
s{\'y}rov{\'y} (adj.)	K{\"a}se-	01 Index adj
{\v{s}}patn{\v{e}}	schlecht (adv.)	02 Index
{\v{s}}patn{\'y}	schlecht (adj.)	02 Index adj
{\v{s}}t{\'{\i}}hl{\'y}	schlank (adj.) (Person)	02 Index adj
{\color{cyan}{\v{s}}vagr}	Schwager	02 Index
{\color{red}{\v{s}}vagrov{\'a}} (adj.)	Schw{\"a}gerin	02 Index adj
tady	hier	02 Index
tancovat, tancuju (impf.)	tanzen (impf.)	03 03b Index Verben
{\color{cyan}tat{\'{\i}}n\uline{e}k}	Vati, Papa	02 Index
te{d'}	jetzt	02 Index
telefonovat, telefonuju (impf.)	telefonieren (impf.)	03 03b Index Verben
{\color{red}televize}	Fernsehen, Fernseher	02 Index
{\color{cyan}ten}, {\color{blue}ten}, {\color{red}ta}, {\color{green}to}	1. der 2. dieser	02 Index
{\color{cyan}tenhle}, {\color{blue}tenhle}, {\color{red}tahle}, {\color{green}tohle}	1. dieser da	02 Index
teplo	warm (adv.)	02 Index
tepl{\'y}	warm (adj.)	02 Index adj
{\color{red}teta}	Tante	02 Index
t{\v{e}}{\v{z}}k{\'y}	1. schwierig 2. schwer (adj.)	02 Index adj
tlust{\'y}	dick (adj.)	02 Index adj
trochu	etwas, ein wenig	02 Index
{\color{red}tu{\v{z}}ka}	Stift, Bleistift	02 Index
{\color{blue}tv{\accent'27u}j}, {\color{cyan}tv{\accent'27u}j}, {\color{red}tvoje/tv{\'a}}, {\color{green}tvoje/tv{\'e}}	dein, dein, deine, dein	02 Index
u{\v{c}}it, u{\v{c}}{\'{\i}}m (impf.)	lehren, unterrichten (impf.)	02 Index Verben
{\color{cyan}u{\v{c}}itel}	Lehrer	02 Index
{\color{red}u{\v{c}}itelka}	Lehrerin	02 Index
ukl{\'{\i}}zet, ukl{\'{\i}}z{\'{\i}}m (impf.)	sauber machen, aufr{\"a}umen (impf.)	03 03b Index Verben
um{\v{e}}t*, um{\'{\i}}m (impf.)	k{\"o}nnen (F{\"a}higkeit) (impf.)	03 03b Index Verben kann unregelmaessig
{\'u}pln{\v{e}}	ganz, vollst{\"a}ndig (adv.)	02 Index
{\color{green}{\'u}ter{\'y}}	Dienstag	03 Index
v l{\'e}t{\v{e}}	im Sommer	03 Index
v noci	in der Nacht	03 Index
v zim{\v{e}}	im Winter	03 Index
v ned{\v{e}}li	am Sonntag	03 Index
v p{\'a}tek	am Freitag	03 Index
v poledne	am Mittag	03 Index
v pond{\v{e}}l{\'{\i}}	am Montag	03 Index
v sobotu	am Sonnabend	03 Index
v {\'u}ter{\'y}	am Dienstag	03 Index
{\color{red}V{\'a}noce} (pl.)	Weihnachten	03 Index
va{\v{r}}it, va{\v{r}}{\'{\i}}m (impf.)	kochen (impf.)	03 03b Index Verben
{\color{cyan}v{\'a}{\v{s}}}, {\color{blue}v{\'a}{\v{s}}}, {\color{red}va{\v{s}}e}, {\color{green}va{\v{s}}e}	euer, eure, euer (duzen) / Ihr, Ihre, Ihr (Siezen)	02 Index
ve {\v{c}}tvrtek	am Donnerstag	03 Index
ve st{\v{r}}edu	am Mittwoch	03 Index
{\color{blue}ve{\v{c}}er}	Abend, am Abend	03 Index
ve{\v{c}}e{\v{r}}et, ve{\v{c}}e{\v{r}}{\'{\i}}m (impf.)	Abendbrot essen, zu Abend essen (impf.)	03 03b Index Verben
{\color{cyan}vegetari{\'a}n}	Vegetarier	02 Index
{\color{red}vegetari{\'a}nka}	Vegetarierin	02 Index
velk{\'y}	gro{\ss} (adj.)	02 Index adj
vesel{\'y}	lustig, fr{\"o}hlich (adj.)	02 Index adj
vlastn{\v{e}}	eigentlich	02 Index
{\color{red}vnu{\v{c}}ka}	Enkelin	02 Index
{\color{cyan}vnuk}	Enkel	02 Index
vst{\'a}vat, vst{\'a}v{\'a}m (impf.)	aufstehen (impf.)	03 03b Index Verben
vysok{\'y}	hoch, gro{\ss} (Mensch) (adj.)	02 Index adj
zamilovan{\'y}	verliebt (adj.)	02 Index adj
zdrav{\'y}	gesund (adj.)	02 Index adj
{\color{red}zima}	1. kalt, 2. Winter	03 Index
z{\'{\i}}tra	morgen	03 Index
{\color{red}zp{\v{e}}va{\v{c}}ka}	S{\"a}ngerin	02 Index
{\color{cyan}zp{\v{e}}v{\'a}k}	S{\"a}nger	02 Index
{\v{z}}e	1. dass 2. nicht wahr? nicht?	02 Index
{\color{red}pan{\'{\i}}}	Frau (i.S.v. Frau Meier)	02
ve {\color{red}{\v{s}}kole}	in der Schule (Schulgeb{\"a}ude)	02
D{\'{\i}}vaj{\'{\i}} se na fotografie.	Schauen Sie die Photographie an.	02
modern{\'{\i}}	modern (adj.)	02 adj
{\color{red}{\v{s}}efka}	Chefin	02
{\color{blue}ruksak}	Rucksack (Fremdwort)	02
sladk{\'y} [pes]	s{\"u}{\ss}er [Hund]	02 adj
pohodln{\'y}	bequem, gem{\"u}tlich (adj.)	02 adj
jednoduch{\'y} [{\color{blue}st{\accent'27u}l}]	einfacher [Tisch] (adj.)	02 adj
lehk{\'y}	leicht (Gewicht, Schwierigkeit, subtil) (adj.)	02 adj
b{\'{\i}}l{\'e} {\color{green}v{\'{\i}}no}	Wei{\ss}wein	02
{\v{c}}erven{\'e} {\color{green}v{\'{\i}}no}	Rotwein	02
{\color{cyan}pes}	Hund	02
A jak{\'y} je asi jeho {\color{cyan}p{\'a}n}?	Und wie ist wohl sein Herrchen?	02 Konversation
{\color{cyan}{\v{C}}ech}, {\color{red}{\v{C}}e{\v{s}}ka}, pl.{\v{C}}e{\v{s}}i	Tscheche, Tschechin, (pl.) Tschechen	02 Index
To v{\'{\i}}te, ...	(Wie) ihr wisst, ...	02
To v{\'{\i}}te, l{\'a}ska je slep{\'a}.	Wie ihr wisst, ist Liebe blind.	02
Je taky {\color{red}u{\v{c}}itelka} jako j{\'a}.	(Sie) ist auch Lehrerin wie ich.	02
star{\v{s}}{\'{\i}} sestra	{\"a}ltere Schwester	02
Je u{\v{z}} moc star{\'y}.	(Er) ist schon sehr alt.	02
vtipn{\'y}	witzig	02 adj
{\color{cyan}prarodi{\v{c}}}	Gro{\ss}elternteil	02
{\color{red}lampa}	Lampe, Laterne	02
{\color{red}{\v{z}}idle}	Stuhl	02
{\color{cyan}abstinent}, {\color{red}abstinentka}	Nichttrinker(in)	02
{\color{red}limon{\'a}da}	Limonade, soft drink	02
{\color{cyan}majitel}	Besitzer	02
abstraktn{\'{\i}}	abstrakt, abgehoben (adj.)	02 adj
{\color{red}nete{\v{r}}}	Nichte	02 Index
{\color{cyan}bratranec}	Cousin	02
{\color{red}sest{\v{r}}enice}	Cousine	02
{\color{cyan}tch{\'a}n}	Schwiegervater	02
{\color{cyan}str{\'y}c}	Onkel (formal)	02
Je p{\v{e}}t ({\v{s}}est, sedm, ...) {\color{red}hodin}.	Es ist f{\"u}nf (sechs, sieben,...) Uhr.	03 Konversation
Jsou dv{\v{e}} (t{\v{r}}i, {\v{c}}ty{\v{r}}i) {\color{red}hodiny}.	Es ist zwei (drei, vier) Uhr.	03
Kolik je {\color{red}hodin}?	Wie sp{\"a}t ist es?/Wieviel Uhr ist es?	03 Konversation
v jednu {\color{red}hodinu}	um ein Uhr	03
V kolik {\color{red}hodin}?	Um wie viel Uhr?	03 Konversation
v p{\v{e}}t ({\v{s}}est, sedm...) {\color{red}hodin}	um f{\"u}nf (sechs, sieben,..) Uhr	03 Konversation
ve dv{\v{e}} (t{\v{r}}i, {\v{c}}ty{\v{r}}i) {\color{red}hodiny}	um zwei (drei, vier) Uhr	03 Konversation
dneska (coll.), dnes	heute (2x)	03
nov{\'y} {\color{blue}kurz}	neuer Kurs	03
o {\color{blue}v{\'{\i}}kendu}	am Wochenende	03
po{\v{c}}{\'{\i}}tejte	Z{\"a}hlt/Z{\"a}hlen Sie	03 Verben
p{\v{r}}{\'{\i}}{\v{s}}t{\'{\i}} {\color{red}lekce}	n{\"a}chste Lektion	03
v {\color{red}tabulce}	in der Tabelle	03
v{\v{s}}echny (pron.-adj.)	alle (pron.-adj.)	03
{\color{blue}film}	Film	03
{\color{blue}listopad}	November	03
{\color{blue}v{\'y}sledek}	Ergebnis	03
{\color{blue}v{\'{\i}}kend}	Wochenende	03
{\color{blue}{\v{r}}{\'{\i}}jen}	Oktober	03
{\color{green}z{\'a}{\v{r}}{\'{\i}}}	September	03
{\color{red}pauza}	Pause	03
{\color{red}tabulka}	Tabelle	03
dokončete věty	Beenden Sie den Satz/Beendet den Satz	03
můžeme	wir können	03 kann
dělejte otázky	Stellt/Stellen Sie Fragen	03
{\color{blue}týden}	Woche	03
rád, ráda, rádo	gern (adj.)	03
Petr rád hraje fotbal	Peter spielt gerne Fußball	03
Změňte věty podle modelu.	Ändern Sie /Ändert die Sätze nach dem Muster	03
dívat se na televizi	fernsehen	03
{\color{red}test}	Test	03
všechno	alles (pronom.)	03
jít do kina	ins Kino gehen	03
hrát* tenis	Tennis spielen	03
hrát* šachy	Schach spielen	03
hrát* basketbal, volejbal	Basketball, Volleyball spielen	03
každý den	jeden Tag	03
když	wenn (Konjunktion)	03
použivejte obrázky	verwenden Sie / verwendet die Bilder	03
jet domů	nach Hause fahren	03
jít do školy	in die Schule gehen	03
chodit do školy	die Schule besuchen	03
prosinec	Dezember	03
roční {\color{green}období}	Jahreszeiten	03
v roce	im Jahr	03
odpovídejte na otázky	Antworten Sie/ Antwortet auf die Frage	03
Čtěte	Lesen Sie/ Lest	03
pít* / piju, piješ, pije, pijeme, pijete, pijou / pil / pij	trinken	03
leden	Januar	03
únor	Februar	03
březen	März	03
duben	April	03
květen	Mai	03
červen	Juni	03
červenec	Juli	03
srpen	August	03
á-Verb konjugieren: dělát	já&nbsp;děl-ám, ty&nbsp;děl-áš, on(a/o)&nbsp;děl-á, my&nbsp;děl-áme, vy&nbsp;děl-áte, oni děl-ájí / (Partizip perfekt) děl-ál		03 grammatik
Typische Endungen á-Verben	-at, + mít		03 grammatik
í-Verb konjugieren: rozumět	já&nbsp;rozum-ím, ty&nbsp;rozum-íš, on(a/o)&nbsp;rozum-í, my&nbsp;rozum-íme, vy&nbsp;rozum-íte, oni rozum-í (seltener) rozum-ějí** / (Partizip perfekt) rozumě-l		03 grammatik
Typische Endungen í-Verben	-et, -ět, -it + jíst, spát, stát		03 grammatik
-ovat Verb konjugieren: pracovat	já prac-uju prac-uji**, ty&nbsp;prac-uješ, on(a/o)&nbsp;prac-uje, my&nbsp;prac-ujeme, vy&nbsp;prac-ujete, oni prac-ujou &nbsp;prac-ují** / (Partizip perfekt) pracova-l		03 grammatik
Typische Endungen ovat-Verben	-ovat		03 grammatik
ě-Verb Präsens konjugieren: čist	já čt-u, ty&nbsp;čt-eš, on(a/o)&nbsp;čt-e, my&nbsp;čt-eme, vy&nbsp;čt-ete, oni čt-ou / (Partizip perfekt) Stammänderung		03 grammatik
7 typische Endungen ě-Verben	-ít, -ýt, -ét, -íst, -ést, -ást, -ůst		03 grammatik
Unterschied v / ve	ve genau dann wenn mindestens 2 Konsonanten folgen		03 grammatik
Je jedna hodina a dvě minuty.	Es ist ein Uhr zwei. (Singular/plural!)	03 Konversation
Je nula hodin.	Es ist null Uhr.	03 Konversation
ve dvacet hodin	um zwanzig Uhr	03 Konversation
Aussprache ě	1. nach b,p,v: [jɛ]. 2. Konsontantenerweichung d,t,n: [jɛ].&nbsp;3. nach m: [njɛ]. 3. sonst [ɛ]		01 grammatik
Aussprache i (nicht í,y,ý)	1. nach d,t,n: [ji]. 2. sonst: [i]		01 grammatik