a tak	und so	Index
{\color{green}áčko}	Linie A	Index
ačkoliv	obwohl (Duplikat)	Index
{\color{blue}Afghánistán}, {\color{cyan}Afghán\uline{e}c}, {\color{red}Afghánka}	Afghanistan, Afghane, Afghanin	Index
ach jo	ach ja	Index
{\color{red}alergie}	Allergie	Index
alimenty	Alimente	Index
{\color{blue}Alžír}, {\color{cyan}Alžířan}, {\color{red}Alžířanka}	Algerien, Algerier, Algerierin	Index
ambiciózní	ambitiös	Index
ananasový (adj.)	Ananas-	Index
ani -- ani	weder - noch	Index
ani	kein (Duplikat)	Index
{\color{red}Argentina}, {\color{cyan}Argentin\uline{e}c}, {\color{red} Argentinka}	Argentinien, Argentinien/Argentinierin	Index
{\color{red}Austrálie}, {\color{cyan}Australan}, {\color{red}Australanka}	Australien, Australier, Australierin	Index
avšak	obwohl (Duplikat)	Index
až	1. wenn 2. bis	Index
{\color{blue}balík}	Paket	Index
balit, balím	packen (impf.)	Index Verben
{\color{red}bankovka}	Banknote	Index
bankovní	Bank-	Index
{\color{cyan}baron}, {\color{red}baronka}	Baron, Baroness	Index
bát se, bojím se	sich fürchten (impf.)	Index Verben
{\color{red}baterie}	Batterie	Index
Baví mě to.	Das macht mir Spaß.	Index
bavit se, bavím se.)	sich unterhalten (impf.) (Duplikat)	Index Verben
bavit, bavím	jmdn. unterhalten (impf.)	Index Verben
{\color{red}bažina}	Sumpf	Index
{\color{green}béčko}	Linie B	Index
běhat, běhám	laufen (impf.)	Index Verben
během	während	Index
{\color{red}Belgie}, {\color{cyan}Belgičan}, {\color{red}Belgičanka}	Belgien, Belgier, Belgierin	Index
{\color{green}Bělorusko}, {\color{cyan}Bělorus}, {\color{red}Běloruska}	Belarus, Belarusse, Belarussin	Index
bez	ohne	Index
Běž pryč!	Geh weg!	Index
{\color{blue}biftek}	Beefsteak	Index
bít	schlagen	Index
{\color{red}blůza}	Bluse (Fremdwort)	Index
blýskat se: Blýská se.	Es blitzt.	Index
bolet, bolí	weh tun, es tut weh (impf.)	Index Verben
Bolí mě hlava.	Ich habe Kopfschmerzen.	Index
Bolí mě v krku.	Ich habe Halsschmerzen.	Index
{\color{red}bota}, boty	Schuh, Schuhe	Index
{\color{red}bouřka}	Sturm	Index
{\color{blue}brambor}, brambory	Kartoffel, Kartoffeln	Index
bramborová {\color{red}polévka}	Kartoffelsuppe	Index
bramborový {\color{blue}salát}	Kartoffelsalat	Index
brát* si, beru si	1. nehmen 2. heiraten (impf.)	Index Verben
brát, beru	nehmen (impf.)	Index Verben
{\color{red}Brazílie}, {\color{cyan}Brazilec}, {\color{red}Brazilka}	Brasilien, Brasilianer, Brasilianerin	Index
bruslit/zabruslit si	Schlittschuh laufen	Index
{\color{red}brýle }pl.	Brille	Index
{\color{green}břicho}	Bauch	Index
Buď hodný/hodná!	Sei lieb!	Index
Buď zticha! (Auch: Buď tiše/ticho! )	Sei ruhig.	Index
{\color{green}Bulharsko}, {\color{cyan}Bulhar}, {\color{red}Bulharka}	Bulgarien, Bulgarier, Bulgarierin	Index
{\color{red}bunda}	Jacke	Index
být na internetu	im Internet sein, im Netz sein	Index
být* nevěrný	untreu sein	Index
být* těhotná	schwanger sein	Index
být* vdaná za	verheiratet sein mit (Frau)	Index
být* zamilovaný	verliebt sein	Index
být* zasnoubený s	verlobt sein mit	Index
být* ženatý s	verheiratet sein mit (Mann)	Index
{\color{green}céčko}	die Linie C	Index
{\color{green}cédé} / {\color{green}cédéčko}	CD	Index
celý	ganz	Index
{\color{red}cena}	Preis	Index
{\color{red}cesta}	Weg, Reise	Index
{\color{red}cigareta}	Zigarette	Index
cítit, cítím	fühlen (impf.)	Index Verben
{\color{blue}citron}	Zitrone	Index
{\color{red}civilizace}	Zivilisation	Index
ctižádostivý	ehrgeizig	Index
{\color{green}cukroví}	Weihnachtsplätzchen	Index
cvičit, cvičím	üben, Gymnastik machen (impf.)	Index Verben
{\color{blue}čas}	Zeit	Index
častěji	öfter	Index
čekat {\color{green}dítě}, čekám {\color{green}dítě}	ein Kind erwarten	Index
čekat, čekám na	warten (impf.)	Index Verben
{\color{blue}česnek}	Knoblauch	Index
česnekový	Knoblauch-	Index
{\color{red}Čína, }{\color{cyan}Číňan}{\color{red}, Číňanka}	China, Chinese, Chinesin	Index
čínský	chinesisch	Index
čokoládový (adj.)	Schokoladen-	Index
čtvereční (adj.)	quadratisch, Quadrat-	Index
čtvrt / {\color{red}čtvrtka}	Viertel	Index
čtvrtý	der vierte	Index
Dále!	Herein!	Index
{\color{green}Dánsko}, {\color{cyan}Dán}, {\color{red}Dánka}	Dänemark, Däne, Dänin	Index
{\color{blue}dár\uline{e}k}	Geschenk	Index
dát si, dám si	nehmen (beim Bestellen im Restaurant) (pf.)	Index Verben
{\color{green}datum}	Datum	Index
dávat, dávám	geben (impf.)	Index Verben
Dávej na sebe pozor.	Gib auf Dich acht.	Index
Dávej pozor!	Pass auf!	Index
Dělej! Dělejte!	Beeil dich! Beeilt euch!	Index
desátý	der zehnte	Index
dětský {\color{blue}pokoj}	Kinderzimmer	Index
devátý	der neunte	Index
{\color{blue}dezert} (oder) {\color{blue}moučník} (oder) {\color{blue}zákus\uline{e}k}	Dessert	Index
díky (coll.)	danke (coll.)	Index
dlouho	lang (adv.)	Index
dlouhý	lang (adj.)	Index
do	bis, nach	Index
Dobrá {\color{red}voda}	"Gutes Wasser" (Mineralwassersorte)	Index
dobře	gut (adv.)	Index
dohromady	zusammen	Index
{\color{blue}doklad}	Dokument (ohne Fremdwort)	Index
dokud	solange	Index
dokud ne	solange bis	Index
{\color{blue}dokument}	Dokument (Fremdwort)	Index
dolem	unten entlang	Index
doleva	nach links	Index
dolů	nach unten	Index
domů	nach Hause	Index
domy pl.	Häuser	Index
doprava	nach rechts (Duplikat)	Index
{\color{red}doprava}	Verkehr, Transport	Index
doprostřed	in die Mitte	Index
dopředu	nach vorn	Index
dostat*, dostanu	bekommen, erhalten (pf.)	Index Verben
dostávat, dostávám	bekommen, erhalten (impf.)	Index Verben
{\color{blue}dostih}	Pferderennen	Index
doufat, doufám	hoffen (impf.)	Index Verben
dovnitř	nach drinnen	Index
dovolená adj.	Urlaub	Index
dovolit, dovolím	erlauben (pf.)	Index Verben
dovolovat, dovoluju	erlauben (impf.)	Index Verben
dozadu	nach hinten	Index
{\color{red}droga}	Droge	Index
druhý	der zweite	Index
družstevní	Genossenschafts-	Index
{\color{blue}důchod}: být* v důchodu	Rente: in Rente sein	Index
dusit, dusím	1. dünsten 2. würgen (impf.)	Index Verben
{\color{cyan}dva}/{\color{blue}dva,} {\color{red}dvě}/{\color{green}dvě}	zwei	Index
dvakrát	zweimal	Index
{\color{red}dveře} pl.	Tür	Index
dvoulůžkový {\color{blue}pokoj}	Zweibettzimmer	Index
{\color{red}džíny} pl.	Jeans	Index
{\color{blue}džob}	Job	Index
{\color{red}džungle}	Dschungel	Index
{\color{cyan}egoista}	Egoist	Index
egoistický	egotistisch	Index
{\color{red}egoistka}	Egoistin	Index
{\color{blue}Egypt}, {\color{cyan}Egypťan}, {\color{red}Egypťanka}	Ägypten,Ägypter, Ägypterin	Index
{\color{cyan}ekonom}, {\color{red}ekonomka}	Kaufmann/-frau, Betriebswirt/-in	Index
emigrovat, emigruju	emigrieren (impf.)	Index Verben
{\color{red}esemeska} / {\color{red}textovka } (coll.)	SMS (coll.)	Index
{\color{green}Estonsko}, {\color{cyan}Eston\uline{e}c}, {\color{red}Estonka}	Estland, Este, Estin	Index
{\color{red}Evropa}, {\color{cyan}Evropan}, {\color{red}Evropanka}	Europa, Europäer, Europäerin	Index
fialový	violett	Index
filozofický	philosophisch	Index
{\color{green}Finsko}, {\color{cyan}Fin}, {\color{red}Finka}	Finland, Finne, Finnin	Index
{\color{red}forma }na pečení	Backform	Index
{\color{cyan}fotograf}, {\color{red}fotografka}	Fotograf, Fotografin	Index
{\color{red}fotografie}	Fotografie	Index
foukat, foukám	blasen (impf.)	Index Verben
{\color{red}Francie}, {\color{cyan}Francouz}{\color{red}, Francouzka}	Frankreich, Franzose, Französin	Index
{\color{red}freska}	Fresko	Index
fyzika	Physik	Index
{\color{red}garáž}	Garage	Index
{\color{red}generace}	Generation	Index
gramatický	grammatisch	Index
{\color{red}gramatika}	Grammatik	Index
grilovat, griluju	grillen (impf.)	Index Verben
{\color{blue}guláš}	Gulasch	Index
gulášová {\color{red}polévka}	Gulaschsuppe	Index
gulášový	Gulasch-	Index
hádat se, hádám se s	sich streiten mit (impf.)	Index Verben
{\color{red}halenka}	Bluse (ohne Fremdwort)	Index
hele!	he!	Index
{\color{red}historie}	Geschichte	Index
{\color{blue}hlad}	Hunger	Index
{\color{red}hlava}	Kopf, Haupt	Index
hlavní	Haupt-	Index
hlavní {\color{green}jídlo}	Hauptgericht	Index
hledat, hledám	suchen (impf.)	Index Verben
hnědý	braun	Index
hodně	viel	Index
hodný	lieb, nett	Index
{\color{green}Holandsko}, {\color{cyan}Holanďan}, {\color{red}Holanďanka}	Holland, Holländer, Holländerin	Index
{\color{red}holčička} (diminuitiv)	kleines Mädchen	Index
{\color{cyan}holič}, {\color{red}holička}	(Herren-) Friseur	Index
Honem!	Schnell!	Index
horem	oben durch, oben entlang	Index
{\color{blue}horoskop}	Horoskop	Index
{\color{red}housle} (pl.)	Violine	Index
hovězí ({\color{green}maso})	Rindfleisch	Index
hovězí {\color{red}polévka}	Rinderbrühe	Index
{\color{red}hra}	Spiel	Index
{\color{red}hranice}	Grenze	Index
{\color{blue}hranol\uline{e}k}, hranolky	Pommes frite, Pomme frites	Index
{\color{blue}hrn\uline{e}c}	Topf	Index
hruškový (adj.)	Birnen-	Index
hřmít*, hřmím	donnern (impf.)	Index Verben
{\color{red}hudba}	Musik	Index
humanistický	humanistisch	Index
{\color{red}chata}	Hütte, Wochenendhaus	Index
{\color{red}chemie}	Chemie	Index
{\color{blue}chlup}	Haar (Körper, Tier)	Index
{\color{green}Chorvatsko}, {\color{cyan}Chorvat}, {\color{red}Chorvatka}	Kroatien, Kroate, Kroatin	Index
{\color{red}chvíle}	Moment, Weile	Index
chytat, chytám	fangen (impf.)	Index Verben
chytit, chytím	fangen (pf.)	Index Verben
i	auch, und auch	Index
i když	auch wenn	Index
{\color{red}Indie}, {\color{cyan}Ind}, {\color{red}Indka}	Indien, Inder, Inderin	Index
{\color{red}Indonésie}, {\color{cyan}Indonésan}, {\color{red}Indonésanka}	Indonesien, Indonesier, Indonesierin	Index
inzerát	Inserat	Index
{\color{blue}Írák}, {\color{cyan}Íráčan}, {\color{red}Íráčanka}	Irak, Iraker, Irakerin	Index
{\color{blue}Írán}{\color{cyan}, Írán\uline{e}c}, {\color{red}Íránka}	Iran, Iraner, Iranerin	Index
{\color{green}Irsko}, {\color{cyan}Ir}, {\color{red}Irka}	Irland, Ire, Irin	Index
irský (adj.)	irisch	Index
{\color{red}Itálie}, {\color{cyan}Ital}, {\color{red}Italka}	Italien, Italiener, Italienerin	Index
{\color{blue}Izrael}, {\color{cyan}Izrael\uline{e}c}, {\color{red}Izraelka}	Israel, Israeli	Index
jablečný (adj.)	Apfel-	Index
jakmile	sobald	Index
{\color{green}Japonsko}, {\color{cyan}Japon\uline{e}c}, {\color{red}Japonka}	Japan, Japaner, Japanerin	Index
jasně (coll.)	klar! (coll.)	Index
jasno	klar (Wetter)	Index
jasný	klar	Index
Je obsazeno.	Es ist besetzt.	Index
{\color{cyan}jed\uline{e}n}/ {\color{blue}jed\uline{e}n}, {\color{red}jedna}, {\color{green}jedno}	1. eins 2. ein	Index
jednolůžkový {\color{blue}pokoj}	Einbettzimmer	Index
jednou	einmal	Index
Jez! Jezte!	Iss! Esst!	Index
jezdit -- jet* na jachtě	auf einer Yacht segeln, fahren (impf.)	Index Verben unregelmaessig
jezdit -- jet* na kole	Fahrrad fahren (impf.)	Index Verben unregelmaessig
jezdit -- jet* na kolečkových bruslích	Inline skates fahren (impf.)	Index Verben unregelmaessig
jezdit -- jet* na lodi	Boot fahren (impf.)	Index Verben unregelmaessig
jezdit -- jet* na skatebordu (na skejtu)	Skateboard fahren (impf.)	Index Verben unregelmaessig
jezdit, jezdím	fahen (impf.)	Index Verben
{\color{green}jezero}	See	Index
jídelní {\color{blue}líst\uline{e}k}	Speisekarte	Index
{\color{blue}jih}	Süden	Index
jinam	anderwohin	Index
jinde	anderswo	Index
jinudy	auf einem anderen Weg	Index
jiný	anderer	Index
{\color{red}jízdenka}	Fahrkarte	Index
jižní	südlich, Süd-	Index
jó (coll.)	ja (coll.)	Index
k / ke	zu	Index
{\color{blue}kabát}	Mantel	Index
{\color{red}kabelka}	Handtasche	Index
{\color{red}kalhotky }pl.	(Damen-) Slip	Index
{\color{red}kalhoty}pl.	Hose	Index
kam	wohin	Index
{\color{red}Kanada, }{\color{cyan}Kanaďan}{\color{red}, Kanaďanka}	Kanada, Kanadier, Kanadierin	Index
{\color{red}kapela}	Kapelle, Band	Index
{\color{red}kapka}	Tropfen	Index
{\color{cyan}kapr}	Karpfen	Index
{\color{red}karta}	Karte	Index
{\color{red}katastrofa}	Katastrophe	Index
{\color{red}katedra}	Lehrstuhl	Index
{\color{cyan}katolík}	Katholik	Index
{\color{red}katolička}	Katholikin	Index
kávový (adj.)	Kaffee-	Index
{\color{blue}Kazachstán}, {\color{cyan}Kazach}, {\color{red}Kazaška}	Kasachstan, Kasache, Kasachin	Index
{\color{blue}kelím\uline{e}k}	Becher (Plaste, Pappe)	Index
{\color{blue}klavír}	Klavier	Index
klidný	ruhig	Index
klouzat*: Klouže to.	Es ist glatt.	Index
{\color{cyan}knihomol}	Bücherwurm	Index
{\color{red}knihovna}	Buchregal	Index
{\color{blue}knír}	Schnurrbart	Index
{\color{red}kočka}	1. Katze 2. (coll.) junges Mädchen	Index
kokosový (adj.)	Kokos-	Index
{\color{red}kola}	Cola	Index
{\color{blue}koláč}	Kuchen	Index
kolem	vorbei	Index
{\color{green}koleno}	Knie	Index
{\color{green}kolo}	Rad, Fahrrad	Index
{\color{blue}kompromis}	Kompromiss	Index
{\color{blue}koňak}	Cognac	Index
koně (pl.)	Pferde	Index
kontrolovat, kontroluju	kontrollieren (impf.)	Index Verben
konzervativní	konservativ	Index
{\color{red}konzultace}	Konsultation, Sprechstunde	Index
{\color{blue}kop\uline{e}c}	Hügel	Index
{\color{green}koření}	Gewürz	Index
{\color{blue}kostým}	Kostüm	Index
{\color{blue}košík}	Körbchen, Korb	Index
{\color{red}košile}	Hemd	Index
koupat* se, koupu se	baden (impf.)	Index Verben
{\color{red}koupelna}	Bad, Badezimmer	Index
koupit, koupím	kaufen (pf.)	Index Verben
{\color{blue}kout}	Ort, Ecke	Index
{\color{blue}kožich}	Pelz	Index
kraj	1. Bezirk, Region 2. Rand	Index
krájet, krájím	schneiden (impf.)	Index Verben
{\color{cyan}král}	König	Index
{\color{red}královna}	Königin	Index
krást*, kradu	stehlen (impf.)	Index Verben
krátký	kurz	Index
{\color{red}kravata}	Kravatte, Schlips	Index
kreslit, kreslím	zeichnen (impf.)	Index Verben
{\color{blue}krk}	Hals	Index
{\color{red}kroketa}, krokety	Krokette, Kroketten	Index
kromě	außer	Index
{\color{green}křeslo}	Sessel	Index
{\color{red}křížovka}	Kreuzworträtsel	Index
který	der, welcher	Index
kudrnatý	lockig, Lochen-	Index
kudy	wo entlang	Index
{\color{cyan}kuchař}	Koch	Index
{\color{red}kuchařka}	1. Köchin, 2. Kochbuch	Index
{\color{red}kuchyň} / {\color{red}kuchyně}	Küche	Index
kuchyňský {\color{blue}kout}	Kochecke, offene Küche	Index
{\color{cyan}kůň}, pl. koně	Pferd, Pferde	Index
Kup to! Kupte to!	Kauf/kauft das!	Index
kupovat, kupuju	kaufen (impf.)	Index Verben
kuřata	Hühner	Index
{\color{green}kuře}	Huhn	Index
kuřecí (adj.)	Hühner-	Index
kuřecí {\color{red}polévka}	Hühnersuppe	Index
kvůli	wegen	Index
kyselý	sauer	Index
{\color{red}kytara}	Gitarre	Index
{\color{red}laguna}	Lagune	Index
{\color{red}láh\uline{e}v}	Flasche	Index
{\color{red}lednička}	Kühlschrank	Index
legendární	legendär	Index
{\color{blue}lék}	Arzneimittel	Index
{\color{red}lékárna}	Apotheke	Index
lepší	besser	Index
{\color{blue}les}	Wald	Index
{\color{red}letenka}	Flugschein, -ticket	Index
lézt*, lezu na skály	Bergsteigen, Klettern (impf.)	Index
lhát*, lžu	lügen (impf.)	Index Verben
{\color{red}linka}	Telefonleitung	Index
{\color{blue}líst\uline{e}k}	Ticket	Index
lít*, liju	gießen (impf.)	Index Verben
{\color{red}Litva}, {\color{cyan}Litev\uline{e}c}, {\color{red}Litevka}	Litauen, Litauer, Litauerin	Index
{\color{red}loď}	Boot, Schiff	Index
{\color{red}lokalita}	Standort, Ort, Anlage	Index
{\color{cyan}losos}	Lachs	Index
{\color{red}loterie}	Lotterie	Index
{\color{green}Lotyšsko}, {\color{cyan}Lotyš}, {\color{red}Lotyška}	Lettland, Lette, Lettin	Index
{\color{red}ložnice}	Schlafzimmer	Index
luštit, luštím křížovku	ein Kreuzworträtsel machen (impf.)	Index
luxovat, luxuju	staubsaugen (impf.)	Index Verben
{\color{red}lžíce}	Suppenlöffel	Index
{\color{red}lžička}	Teelöffel	Index
{\color{green}Maďarsko}, {\color{cyan}Maďar}, {\color{red}Maďarka}	Ungarn, Ungar, Ungarin	Index
{\color{cyan}malíř}	Maler	Index
{\color{red}malířka}	Malerin	Index
{\color{green}Maroko}, {\color{cyan}Maročan}, {\color{red}Maročanka}	Marokko, Marokkaner, Marokkanerin	Index
{\color{red}maturita}	Abitur	Index
maturovat, maturuju	das Abitur machen	Index
maximálně	maximal	Index
med	Honig	Index
měkký	weich	Index
měřit, měřím	messen (impf.)	Index Verben
{\color{blue}metr}	Meter	Index
{\color{green}Mexiko}, {\color{cyan}Mexičan}, {\color{red}Mexičanka}	Mexiko, Mexikaner, Mexikanerin	Index
mezi	1. zwischen 2. unter	Index
míchat, míchám	mischen (impf.)	Index Verben
{\color{red}mikina}	Sweatshirt	Index
milovat se, miluju se	sich lieben (impf.)	Index Verben
milovat, miluju	lieben (impf.)	Index Verben
milý	lieb	Index
minulý	vergangener	Index
{\color{red}minuta}	Minute	Index
{\color{red}místnost}	Raum	Index
{\color{green}místo}	Ort	Index
mixovat, mixuju	mixen (impf.) (Duplikat)	Index Verben
{\color{cyan}model}, {\color{red}modelka}	Modell	Index
modrý	blau	Index
mokrý	nass	Index
možný	möglich	Index
mrznout*, mrznu	frieren	Index
my	wir	Index
na univerzitě	an der Universität	Index
nabídnout*, nabídnu	anbieten (pf.)	Index Verben
nabízet, nabízím	anbieten (impf.)	Index Verben
{\color{blue}nábyt\uline{e}k}	Möbel	Index
nad	über	Index
nadmořská {\color{blue}výška}	Höhe über dem Meeresspiegel	Index
nacházet, nacházím	finden (impf.)	Index Verben
najednou	auf einmal	Index
nakonec	am Ende, schließlich	Index
nakoupit	einkaufen	Index
nakrájet, nakrájím	in Scheiben schneiden (pf.)	Index Verben
{\color{blue}nákup}	Einkauf	Index
{\color{red}nálada}	Laune, Stimmung	Index
nalít*, naliju	eingießen, einschenken (pf.)	Index Verben
namalovat, namaluju	malen (Bild) (pf.)	Index Verben
{\color{blue}nápad}	Idee, Einfall	Index
{\color{blue}nápoj}	Getränk	Index
napravo	nach rechts (Duplikat)	Index
naproti	gegenüber	Index
narodit se, narodím se	geboren werden (pf.)	Index Verben
{\color{red}narozeniny }(pl.)	Geburtstag	Index
nastoupit, nastoupím	einsteigen (pf.)	Index Verben
nastupovat, nastupuju	einsteigen (impf.)	Index Verben
nasypat*, nasypu	schütten, streuen (Zucker, Mehl) (pf.)	Index Verben
naštěstí	zum Glück	Index
natočit, natočím	einen Film drehen (pf.)	Index Verben
naučit se, naučím se	lernen (pf.)	Index Verben
{\color{red}náušnice}	Ohrring	Index
{\color{red}návštěva}	Besuch	Index
nebezpečný	gefährlich	Index
Neboj se! Nebojte se!	Hab/habt keine Angst!	Index
něco	etwas	Index
něčí	jemandes'	Index
Nedělej si starosti. Nedělejte si starosti.	Mach dir / Macht euch keine Sorgen.	Index
Nech toho! Nechte toho!	Lass das!	Index
nechat, nechám	lassen (pf.)	Index Verben
nechávat, nechávám	lassen (impf.)	Index Verben
nějak	irgenwie	Index
nejdražší	der teuerste	Index
nejdřív	zuerst	Index
nejpopulárnější	der populärste	Index
někde	irgendwo	Index
někdo	irgendwer	Index
několik	einige	Index
nekvalitní	von schlechter Qualität	Index
nemožný	unmöglich	Index
nenávidět, nenávidím	hassen (impf.)	Index Verben
neobvyklý	ungewöhnlich	Index
Neotravuj mě! Neotravujte mě!	Nerv/nervt mich nicht!	Index
neperlivá voda	Mineralwasser ohne Kohlensäure	Index
Neplač! Neplačte!	Weine/weint nicht!	Index
Neruš mě! Neruště mě!	Stör/stört mich nicht!	Index
nesnášet, nesnáším	ertragen (impf.)	Index Verben
nesnést*, nesnesu	ertragen (pf.)	Index Verben
nespolečenský	ungesellig	Index
nést*, nesu	tragen (Kleidung, Last) (impf.)	Index Verben
{\color{red}nevýhoda}	Nachteil	Index
nezdravý	ungesund	Index
než	1. als (Vergleich); 2. bevor	Index
nic	nichts	Index
ničí	niemandes	Index
nijak	keinerlei, auf keinerlei Weise	Index
nikde	nirgendwo	Index
nikdo	nirgenwer	Index
nikdy	niemals	Index
{\color{red}noha}	1.Fuß, 2. Bein	Index
normální	normal	Index
{\color{green}Norsko}, {\color{cyan}Nor}, {\color{red}Norka}	Norwegen, Norweger, Norwegerin	Index
{\color{blue}nos}	Nase	Index
nosit, nosím	tragen (Kleidung, Last) (impf.)	Index Verben
nosní	Nasen-, nasal	Index
Nový {\color{blue}Zéland}, {\color{cyan}Novovozélanďan}, {\color{red}-ka}	Neuseeland, Neuseeländer, Neuseeländrin	Index
nultý	der nullte	Index
{\color{blue}nůž}	Messer	Index
o	über, von	Index
obalit, obalím	einwickeln (pf.)	Index Verben
obalovat, obaluju	einwickeln (impf.)	Index Verben
{\color{blue}oběd}	Mittagessen	Index
objevit, objevím	entdecken (pf.)	Index Verben
objevovat, objevuju	entdecken (impf.)	Index Verben
obléct*, obleču	anziehen (pf.)	Index Verben
{\color{green}oblečení}	Bekleidung	Index
{\color{blue}oblek}	Anzug	Index
oblékat, oblékám	anziehen (impf.)	Index Verben
{\color{blue}obličej}	Gesicht	Index
{\color{blue}obraz}	Bild	Index
obvyklý	gewöhnlich (adj.)	Index
{\color{blue}obývák}	Wohnzimmer	Index
{\color{blue}oceán}	Ozean	Index
oči	augen	Index
oční (adj.)	Augen-	Index
od	von (Duplikat)	Index
ode	von (Duplikat)	Index
od\uline{e}jít*, odejdu	weggehen (impf.) (Duplikat)	Index Verben
odcházet, odcházím	weggehen (impf.) (Duplikat)	Index Verben
odjinud	von anderswoher, von einem Ort	Index
odjíždět, odjíždím	abfahren, wegfahren (impf.)	Index Verben
Odlož si. Odložte si.	Leg/legen Sie ab.	Index
odpočinout* si, odpočinu si	sich ausruhen (pf.)	Index Verben
odskočit si, odskočím si	auf Toilette gehen (pf.)	Index Verben
odsud	von hier	Index
odtamtud	von dort (aus)	Index
{\color{green}okno}	Fenster	Index
{\color{green}oko}, pl. oči	Auge, Augen	Index
okurkový (adj.)	Gurken-	Index
{\color{red}omáčka}	Soße	Index
{\color{red}omeleta}	Omelette	Index
on	er	Index
ona	sie (3. P. Sg.)	Index
oni	sie (3. P. Pl.)	Index
opálit se, opálím se	sich sonnen (pf.)	Index Verben
opalovat se, opaluju se	sich sonnen (impf.)	Index Verben
opravdový	wirklicher, echter	Index
opravit, opravím	1. reparieren 2. korrigieren (pf.)	Index Verben
opravovat, opravuju	1. reparieren 2. korrigieren (impf.)	Index Verben
oranžový	orange	Index
{\color{red}ordinace}	Praxis, Behandlungszimmer	Index
{\color{blue}orchestr}	Orchester	Index
{\color{red}oslava}	Feier	Index
osmý	der achte	Index
osobní	persönlich	Index
ospalý	verschlafen (adj.)	Index
{\color{blue}ostrov}	Insel	Index
ovocný (adj.)	Obst-	Index
oženit se, ožením se	heiraten (Mann)	Index
pak	dann	Index
{\color{red}palačinka}	Palatschinken	Index
paličatý	dickköpfig	Index
{\color{red}památka}	Sehenswürdigkeit, Denkmal	Index
{\color{red}pán\uline{e}v}	Pfanne	Index
{\color{blue}papír}	Papier	Index
{\color{green}papírnictví}	Papierwarengeschäft	Index
pardon	Pardon, Entschuldigung	Index
{\color{blue}pas}	Pass	Index
{\color{red}pastelka}	Buntstift, Wachsstift	Index
{\color{green}patro}	Etage	Index
pátý	der fünfte	Index
péct*, peču	backen (impf.)	Index Verben
pečený	gebacken	Index
{\color{green}peklo}	Hölle	Index
{\color{red}peněženka}	Portemonnaie	Index
{\color{blue}peníze} (pl.)	Geld	Index
{\color{red}penze}	Rente	Index
{\color{blue}pepř}	Pfeffer	Index
perlivý	mit Kohlensäure	Index
{\color{green}pero}	Stift, Feder	Index
{\color{cyan}p\uline{e}s}	Hund	Index
pevná {\color{red}linka}	Festnetzanschluss	Index
pevný	fest	Index
{\color{cyan}pirát}	Pirat	Index
{\color{red}písnička}	Lied	Index
pistáciový (adj.)	Pistazien-	Index
plakat*, pláču	weinen (impf.)	Index Verben
plánovat, plánuju	planen (impf.)	Index Verben
platit, platím	zahlen (impf.)	Index Verben
{\color{red}plavky} (pl.)	Badehose, Badeanzug, Bikini	Index
{\color{red}pláž}	Strand	Index
{\color{red}pleš}	Glatze	Index
plná {\color{red}penze}	Vollpension	Index
plný	voll	Index
po	1. nach 2. durch	Index
{\color{green}počasí}	Wetter	Index
počkat, počkám	warten (pf.)	Index Verben
pod	unter	Index
podél	entlang	Index
podívat se na	sich etwas anschauen (pf.)	Index Verben
podle	nach, laut	Index
{\color{blue}podnájem}	Untermiete	Index
pohádat se s	sich streiten mit (pf.)	Index Verben
{\color{red}pohádka}	Märchen	Index
Pojď dál! Pojďte dál!	Komm herein! Kommt herein!	Index
{\color{red}poklice}	Deckel	Index
{\color{blue}pokoj}	Raum, Zimmer	Index
{\color{red}polévka}	Suppe	Index
poliklinika	Poliklinik	Index
{\color{red}polívka} (coll.)	Suppe (coll.)	Index
{\color{red}poloha}	Lage	Index
{\color{blue}poloostrov}	Halbinsel	Index
{\color{red}polopenze}	Halbpension	Index
polotučný	fettarm	Index
{\color{green}Polsko}, {\color{cyan}Polák}, {\color{red}Polka}	Polen, Pole, Polin	Index
pomáhat, pomáhám	helfen (impf.)	Index Verben
pomeračnový (adj.)	Orangen-	Index
pomilovat se, pomiluju se	miteinander schlafen (pf.)	Index Verben
{\color{red}pomoc}	Hilfe	Index
pomoct*, pomůžu	helfen (pf.)	Index Verben
{\color{red}ponožka}	Socke	Index
poprvé	zum ersten Mal	Index
{\color{red}porce}	Portion	Index
{\color{blue}pór\uline{e}k}	Porré	Index
porodit, porodím	gebären, entbinden (pf.)	Index Verben
portrét	Portrait	Index
{\color{green}Portugalsko}, {\color{cyan}Portugal\uline{e}c}, {\color{red}Portugalka}	Portugal, Portugiese, Portugieserin	Index
pořád	ständig	Index
{\color{blue}pořád\uline{e}k}	Ordnung	Index
Posaď se! Posaďte se!	Setz dich! Setzt euch! / Setzen Sie sich!	Index
posílat, posílám	schicken (impf.)	Index Verben
posílit, posílím	(be)stärken	Index
posilovat, posiluju	(be)stärken, kräftigen (impf.)	Index Verben
poslat*, pošlu	schicken (pf.)	Index Verben
poslechnout*, poslechnu	1. (zu)hören 2. gehorchen (pf.)	Index Verben
Pospěš si! Pospěšte si!	Beeil dich / beeilt euch!	Index
{\color{red}postava}	Figur	Index
postavit, postavím	bauen (pf.)	Index Verben
{\color{red}postel}	Bett	Index
potápět se, potápím se	tauchen (impf.)	Index Verben
potkat, potkám	treffen (pf.)	Index Verben
potkávat, potkávám	treffen (impf.)	Index Verben
potopit se, potopím se	tauchen (pf.)	Index Verben
potřebovat, potřebuju	1. brauchen, 2. müssen (als Hilfsverb) (impf.)	Index Verben
{\color{red}poušť}	Wüste	Index
použít*, použiju	verwenden, gebrauchen (pf.)	Index Verben
{\color{red}povaha}	Charakter	Index
pověrčivý	superstitious	Index
povídat si, povídám si	sich unterhalten (impf.) (Duplikat)	Index Verben
{\color{red}povídka}	Erzählung	Index
pozdě	spät	Index
později	später	Index
{\color{blue}pozdrav}	Gruß	Index
Pozdravuj! Pozdravujte!	Sag guten Tag zu...! Sagt guten Tag zu...!	Index
pozvat*, pozvu	einladen (pf.)	Index Verben
požádat, požádám	beantragen, bitten (offiziell) (pf.)	Index Verben
{\color{red}pračka}	Waschmaschine	Index
praktický	praktisch	Index
prát*, peru (oblečení)	waschen (Kleidung) (impf.)	Index Verben
preferovat, preferuju	präferieren (impf.)	Index Verben
pro	für	Index
probudit se, probudím se	aufwachen (pf.)	Index Verben
prodat, prodám	verkaufen (pf.)	Index Verben
{\color{cyan}prodavač}	Verkäufer	Index
{\color{red}prodavačka}	Verkäuferin	Index
prodávat, prodávám	verkaufen (impf.)	Index Verben
profesinální (adj.)	professionell	Index
prohlédnout*, prohlédnu	besichtigen, durchsehen (pf.)	Index Verben
prohlížet si památky	Sehenwürdigkeiten besichtigen (impf.)	Index
prohlížet, prohlížím	besichtigen, durchsehen (impf.)	Index Verben
{\color{blue}projekt}	Projekt	Index
prominout*, prominu	vergeben, entschuldigen (pf.)	Index Verben
{\color{red}promoce}	akademische Abschlussfeier mit Zeugnisübergabe	Index
promovat, promuju	einen akademischen Abschluss machen, feiern (impf.)	Index Verben
prostě	einfach	Index
prostředkem	durch die Mitte	Index
prostřední	Mitte	Index
proti	gegen	Index
protivný	ungezogen, widerwärtig	Index
{\color{red}próza}	Prosa	Index
{\color{blue}prst}	1. Finger, 2. Zeh	Index
pršet	regnen	Index
první	der erste	Index
přát*, přeju	wünschen (impf.)	Index Verben
přečíst*, přečtu	durchlesen (pf.)	Index Verben
před	vor (zeitl. und örtl)	Index
předem	im Voraus	Index
{\color{red}předpověď }počasí	Wettervorhersage	Index
předpovědět, předpovím	vorhersagen, voraussagen (pf.)	Index Verben
předpovídat, předpovídám	vorhersagen, voraussagen (impf.)	Index Verben
představit, představím	vorstellen (pf.)	Index Verben
představovat, představuju	vorstellen (impf.)	Index Verben
{\color{red}přeháňka}	Regenschauer	Index
překládat, překládám	übersetzen (impf.)	Index Verben
{\color{cyan}překladatel}	Übersetzer	Index
{\color{red}překladatelka}	Übersetzerin	Index
přeložit, přeložím	übersetzen (pf.)	Index Verben
přepojit	verbinden (pf.)	Index Verben
přepojovat, přepojuju	verbinden (impf.)	Index Verben
přes	über	Index
přestěhovat (se), přestěhuju se	umziehen (pf.)	Index Verben
přesto	trotzdem (Duplikat)	Index
přestože	trotzdem (Duplikat)	Index
přežít*, přežiju	überleben (pf.)	Index Verben
přidat, přidám	hinzugeben (pf.)	Index Verben
přidávat, přidávám	hinzufügen, zusetzen, dazutun (impf.)	Index Verben
Přijď! Přijďte!	Komm! Kommt! (laufen)	Index
Přijeď! Přijeďte!	Komm! Kommt! (fahren)	Index
přijít*, přijdu	kommen (laufen) (pf.)	Index Verben
přiletět, přiletím	kommen (fliegen) (pf.)	Index Verben
{\color{red}příloha}	Beilage (Essen)	Index
připravit, připravím	vorbereiten (pf.)	Index Verben
připravovat, připravuju	vorbereiten (impf.)	Index Verben
přísný	streng	Index
PSČ (lies: pé es čé)	Postleitzahl	Index
{\color{cyan}pstruh}	Forelle	Index
ptát se, ptám se koho	fragen (impf.)	Index Verben
{\color{red}půjčovna}	Vermietung, Leihstelle	Index
půl	halb	Index
{\color{red}půlka}	Hälfte	Index
{\color{red}pusa} (coll.)	1. Mund 2. Kuss (coll.)	Index
{\color{red}radioaktivita}	Radioactivität	Index
raftovat	Rafting machen (impf.)	Index Verben
{\color{blue}ráj}	Paradies	Index
{\color{green}rameno}	Schulter	Index
{\color{green}rande}	Rendezvous	Index
{\color{red}rekonstrukce}	Rekonstruktion, Sanierung	Index
religiózní	religiös	Index
rezervovat, rezervuju	reservieren, buchen (impf.)	Index Verben
{\color{cyan}režisér}	Regisseur	Index
{\color{red}režisérka}	Regisseurin	Index
rodit se, rodím se	geboren werden (impf.)	Index Verben
rodit, rodím	entbinden, gebären (impf.)	Index Verben
{\color{red}roláda}	Roulade	Index
{\color{blue}rolák}	Rollkragenpullover	Index
{\color{blue}román}	Roman	Index
rozejít se*, rozejdu se	auseinandergehen, Schluss machen (pf.)	Index Verben
rozcházet se, rozcházím se	ausseinandergehen, Schluss machen (impf.)	Index Verben
rozpuštěný	aufgelöst, zerlassen	Index
rozvádět se, rozvádím se	sich scheiden lassen (impf.)	Index Verben
rozvést* se, rozvedu se	sich scheiden lassen (pf.)	Index Verben
ruce (pl.)	Hände	Index
{\color{red}ruka}, pl. ruce	1. Hand 2. Arm	Index
{\color{red}rukavice}	Handschuh	Index
{\color{green}Rumunsko}, {\color{cyan}Rumun}, {\color{red}Rumunka}	Rumänien, Rumäne, Rumänin	Index
růžový	rosa	Index
{\color{red}ryba}, pl. ryby	Fisch, Fische	Index
rybařit	angeln	Index
rýma	Schnupfen	Index
{\color{red}rýže}	Reis	Index
{\color{green}Řecko}, {\color{cyan}Řek}, {\color{red}Řekyně}	Griechenland, Grieche, Griechin	Index
říct*, řeknu	sagen (pf.)	Index Verben
{\color{cyan}řidič}	Fahrer	Index
{\color{red}řidička}	Fahrerin	Index
řídit, řídím	1. fahren 2. leiten (impf.)	Index Verben
{\color{blue}říz\uline{e}k}	Schnitzel	Index
s	mit	Index
S dovolením!	Gestatten Sie bitte!	Index
{\color{blue}sáč\uline{e}k}	Tüte (Plaste)	Index
{\color{green}sako}	Jackett, Sakko	Index
{\color{blue}salám}	Salami	Index
{\color{cyan}sám}/{\color{blue}sám}, {\color{red}sama}, {\color{green}samo}	1. allein 2. selbst	Index
samuraj	Samurai	Index
sbalit, sbalím	packen (pf.)	Index Verben
sbírat, sbírám	1. auflesen 2. sammeln (impf.)	Index Verben
{\color{cyan}scénárista}	Drehbuchautor (m.)	Index
{\color{red}scénáristka}	Drehbuchautorin	Index
{\color{blue}scénář}	Drehbuch	Index
se	3. mit 1. sich 2. einander (Akk.)	Index
sebrat*, seberu	auflesen, einsammeln (pf.)	Index Verben
sedmý	der siebente	Index
sejít* se, sejdu se	sich treffen (pf.) (Duplikat)	Index Verben
sem	her, hierher	Index
{\color{blue}sešit}	Heft	Index
setkat se, setkám se	sich treffen (pf.) (Duplikat)	Index Verben
setkávat se, setkávám se	sich regelmäßig treffen (impf.)	Index Verben
{\color{blue}sever}	Norden	Index
severní	northern	Index
seznámit se, seznámím se	1. sich kennenlernen, 2. sich informieren (pf.)	Index Verben
seznamovat se, seznamuju se	1. sich kennenlernen, 2. sich informieren (impf.)	Index Verben
shora	von oben	Index
{\color{red}schůze}	Versammlung	Index
{\color{red}schůzka}	Verabredung	Index
si	1. sich 2. einander (Dat.)	Index
silnější	stärker	Index
{\color{red}skála}	Skala	Index
{\color{red}skládačka}	Puzzle	Index
skládat, skládám	1. zusammensetzen, 2. komponieren (impf.)	Index Verben
{\color{cyan}skladatel}	Komponist	Index
{\color{red}skladatelka}	Komponistin	Index
{\color{red}sklenice}	Glas	Index
skončit, skončím	beenden, enden (pf.)	Index Verben
{\color{green}Skotsko}, {\color{cyan}Skot}, {\color{red}Skotka}	Schottland, Schotte, Schottin	Index
skrz	durch	Index
{\color{red}skříň}	Schrank	Index
{\color{red}skupina}	Gruppe	Index
skvělý	toll, großartig, perfekt	Index
{\color{red}slanina}	Speck	Index
slavný	berühmt	Index
{\color{blue}slipy} (pl.)	Slip	Index
{\color{green}Slovensko}, {\color{cyan}Slovák}, {\color{red}Slovenka}	Slowakei, Slowake, Slowakin	Index
{\color{green}Slovinsko}, {\color{cyan}Slovin\uline{e}c}, {\color{red}Slovinka}	Sowenien, Slowene, Slowenin	Index
{\color{red}složenka}	Überweisungsschein	Index
složit, složím	1. zusammensetzen, 2. komponieren (pf.)	Index Verben
slunečno	sonnig (adv.)	Index
slunečný	sonnig (adj.)	Index
{\color{red}služba}, služby	Dienst, Dienste	Index
služební {\color{red}cesta}	Dienstreise	Index
smažený	gebraten und paniert	Index
smažit, smažím	braten (impf.)	Index Verben
{\color{blue}směr}	Richtung	Index
{\color{red}smetana}	Sahne	Index
{\color{red}smůla}	Pech	Index
snad	vielleicht	Index
sněžit, sněží	schneien, es schneit (impf.)	16 Index Verben vorgefertigt
{\color{red}snídaně}	Frühstück	Index
sníst*, sním	aufessen (pf.)	Index Verben
sobecký	egoistisch	Index
{\color{red}socha}	Statue, Skulptur	Index
{\color{red}sopka}	Vulkan (nicht Fremdwort)	Index
{\color{blue}soprán}	Sopran	Index
{\color{red}soustrast}	Mitleid	Index
{\color{green}spaní}	das Schlafen	Index
speciální	speziell	Index
{\color{cyan}spisovatel}	Schriftsteller	Index
{\color{red}spisovatelka}	Schriftstellerin	Index
spíš	eher, wahrscheinlich	Index
spíše (formal)	eher, wahrscheinlich (formal)	Index
spočítat, spočítám	zählen (pf.)	Index Verben
spokojený	zufrieden	Index
{\color{red}spokojenost}	Zufriedenheit	Index
spolehlivý	zuverlässig	Index
{\color{blue}sporák}	Herd	Index
sprostý	vulgär	Index
{\color{green}Srbsko}, {\color{cyan}Srb}, {\color{red}Srbka}	Serbien, Serbe, Serbin	Index
{\color{red}starožitnost}	Antiquität	Index
{\color{blue}stát}	Staat	Index
stát*, stojí	1. kosten, 2. stehen (impf.)	Index Verben
statečný	tapfer, standhaft	Index
stavět, stavím	bauen (impf.)	Index Verben
stěhovat (se), stěhuju (se)	umziehen (impf.)	Index Verben
stejný	derselbe, der gleiche	Index
{\color{blue}strach}	Angst	Index
{\color{red}strana}	1. Partei, 2. Seite	Index
{\color{red}stránka}	Seite (Buch)	Index
{\color{green}stravování}	Verpflegung	Index
{\color{cyan}striptér}	Stripper	Index
{\color{red}striptérka}	Stripperin	Index
střední škola	Mittelschule (bis zum Abitur)	Index
stříbrný	silbern	Index
{\color{blue}stůl}	Tisch	Index
{\color{blue}Súdán}, {\color{cyan}Súdán\uline{e}c}, {\color{red}Súdánka}	Sudan, Sudanese, Sudanesin	Index
sucho	trocken (adv.)	Index
suchý	trocken (adj.)	Index
{\color{red}sukně}	Rock	Index
{\color{red}sušenka}	Plätzchen, Gebäck	Index
{\color{red}svatba}	Hochzeit	Index
{\color{blue}svát\uline{e}k}	1. Feiertag 2. Namenstag	Index
{\color{blue}svět}	Welt	Index
světlý	hell	Index
{\color{blue}svetr}	Pullover	Index
svíčková {\color{red}omáčka}	Sahnesoße	Index
sypat*, sypu	schütten, streuen (Mehl, Zucker) (impf.)	Index Verben
{\color{red}šála}	Schal	Index
šampaňské (adj.)	Champagner	Index
{\color{red}šance}	Chance	Index
{\color{blue}šanson}	Chanson	Index
{\color{red}šaty} (pl.)	Kleid, Kleidung	Index
šedý	grau	Index
{\color{cyan}šéfkuchař}	Chefkoch	Index
{\color{red}šéfkuchařka}	Chefköchin	Index
{\color{blue}šek}	Scheck	Index
šestý	der sechste	Index
{\color{red}školka} / mateřská {\color{red}škola}	Kindergarten	Index
šlehačka	Schlagsahne	Index
šlehačkový (adj.)	Sahne-	Index
{\color{red}šortky} (pl.)	Shorts, kurze Hosen	Index
{\color{green}Španělsko}, {\color{cyan}Španěl}, {\color{red}Španělka}	Spanien, Spanier, Spanierin	Index
špinavý	schmutzig	Index
šťastný	glücklich	Index
{\color{green}štěstí}	Glück	Index
šunkový (adj.)	Schinken-	Index
{\color{green}Švédsko}, {\color{cyan}Švéd}, {\color{red}Švédka}	Schweden, Schwede, Schwedin	Index
{\color{green}Švýcarsko}, {\color{cyan}Švýcar}, {\color{red}Švýcarka}	Schweiz, Schweizer, Schweizerin	Index
{\color{blue}tabák}	Tabak	Index
tak	so (Duplikat)	Index
také (formal)	auch (formal)	Index
takový	so einer	Index
takže	so (Duplikat)	Index
tamhle	dort, dort da	Index
tamtudy	dort entlang	Index
tatarská {\color{red}omáčka}	Sauce Tatar	Index
telefonní {\color{blue}seznam}	Telefonbuch	Index
televizní (adj.)	Fernseh-	Index
{\color{green}tělo}	Körper	Index
{\color{red}terasa}	Terasse	Index
těšit se, těším se	sich freuen (impf.)	Index Verben
textová {\color{red}zpráva}	SMS	Index
To nic!	Macht nichts!	Index
točit, točím	einen Film drehen (impf.)	Index Verben
tomatový (adj.)	Tomaten-	Index
{\color{red}trafika}	Zigaretten- und Zeitungskiosk	Index
{\color{red}tragédie}	Tragödie	Index
{\color{red}trasa}	Strecke, Route	Index
{\color{blue}trapas}	Faux pas, Peinlichkeit	Index
trapný	peinlich	Index
trh	Markt	Index
{\color{red}trpělivost}	Geduld	Index
{\color{green}tričko} / {\color{green}triko}	T-shirt	Index
{\color{red}trouba}	Röhre	Index
{\color{red}trubka}	Trompete	Index
trvanlivý	ständig, Dauer-	Index
třetí	der dritte	Index
{\color{red}třída}	1. Klasse 2. Straße	Index
třikrát	dreimal	Index
tučný	fett (Essen)	Index
tudy	hier entlang	Index
{\color{blue}tuk}	Fett	Index
{\color{green}Turecko}, {\color{cyan}Tur\uline{e}k}, {\color{red}Turkyně}	Türkei, Türke, Türkin	Index
turecký (adj.)	türkisch	Index
turistický (adj.)	touristisch, Touristen-	Index
tvrdohlavý	hartnäckig, starrköpfig	Index
tvrdý	hart	Index
{\color{blue}týd\uline{e}n}	Woche	Index
u	bei	Index
{\color{green}ubytování}	Unterkunft	Index
{\color{green}údolí}	Tal	Index
udusit, udusím	1. dünsten 2. ersticken (pf.)	Index Verben
{\color{green}ucho}, pl. uši	Ohr, Ohren	Index
ukázat*, ukážu	zeigen (pf.)	Index Verben
ukazovat, ukazuju	zeigen (impf.)	Index Verben
uklidit, uklidím	sauber machen (pf.)	Index Verben
{\color{cyan}uklízeč}	Reinigungskraft	Index
{\color{red}uklízečka}	Reinemachefrau, Reinigungskraft	Index
{\color{red}Ukrajina}, {\color{cyan}Ukrajinec}, {\color{red} Ukrajinka}	Ukraine, Ukrainer, Ukrainerin	Index
ukrást*, ukradnu	stehlen (pf.)	Index Verben
umírat, umírat	sterben (impf.)	Index Verben
umřít*, umřu	sterben (pf.) (Duplikat)	Index Verben
umýt*, umyju	waschen, abwaschen (pf.)	Index Verben
{\color{red}univerzita}	Universität	Index
upéct*, upeču	backen (pf.)	Index Verben
upřímný	aufrichtig	Index
{\color{cyan}úředník}, {\color{red}úřednice}	Beamter, Beamtin	Index
USA pl. (lies: ú es á)	USA	Index
usmažit, usmažím	braten, panieren (pf.)	Index Verben
{\color{green}ústa }(pl.)	Mund	Index
uši	Ohren	Index
uvařit, uvařím	kochen (pf.)	Index Verben
uvidět, uvidím	sehen (pf.)	Index Verben
uzený	geräuchert	Index
Užij si to! Užijte si to!	Genieß es! (2x)	Index
v	in (Duplikat)	Index
v práci	auf Arbeit	Index
{\color{green}vajíčko}	Ei	Index
{\color{red}vana}	Badewanne	Index
vanilkový (adj.)	Vanille-	Index
vánoční (adj.)	Weihnachts-	Index
{\color{red}vázanka}	Kravatte, Binder	Index
včera	gestern	Index
vdaná	verheiratet (Frau)	Index
vdát* se, vdám se	heiraten (Frau) (pf.)	Index Verben
vdávat se, vdávám se	heiraten (Frau) (impf.)	Index Verben
ve	in (Duplikat)	Index
{\color{red}večeře}	Abendessen	Index
vědět*, vím	wissen (impf.)	Index Verben
vedle	neben	Index
{\color{green}vedro}	Hitze	Index
Velká {\color{red}Británie, }{\color{cyan}Brit}, {\color{red} Britka}	Großbritannien, Brite, Britin	Index
velmi	sehr	Index
ven	hinaus	Index
venkem	draußen hindurch	Index
vepřové ({\color{green}maso})	Schweinefleisch	Index
věřící (adj.)	Gläubiger	Index
vevnitř	drinnen (selteneres Wort)	Index
vézt*, vezu	transportieren (fahren) (pf.)	Index Verben
vídeňský (adj.)	Wiener	Index
vidět, vidím	sehen (impf.)	Index Verben
{\color{red}vidlička}	Gabel	Index
{\color{blue}Vietnam}, {\color{cyan}Vietnamec}, {\color{red}Vietnamka}	Vietnam, Vietnamese, Vietnamesin	Index
{\color{red}vila}	Villa	Index
vítat, vítám	willkommen heißen (impf.)	Index Verben
{\color{blue}vítr}	Wind	Index
{\color{green}víza} (pl.)	Visa	Index
{\color{green}vízum}, pl. {\color{green}víza}	Visum	Index
{\color{blue}vlak}	Zug	Index
vlastní	eigener	Index
{\color{green}vlastnictví}	Eigentum	Index
vlasy (pl.)	Haare (Kopf)	Index
vnitřkem	innen hindurch	Index
{\color{red}voda}	Wasser	Index
vodní (adj.)	Wasser-	Index
volat, volám	rufen, anrufen (impf.)	Index Verben
volno	frei	Index
{\color{blue}vousy} (pl.)	Bart	Index
vprostředku	in der Mitte	Index
vstát*, vstanu	aufstehen (pf.)	Index Verben
však	jedoch	Index
vulgární	vulgär	Index
{\color{blue}vulkán}	Vulkan (Fremdwort)	Index
vy	ihr, Sie	Index
výborně	ausgezeichnet (adv.)	Index
výborný	ausgezeichnet (adj.)	Index
{\color{red}výhoda}	Vorteil	Index
vyhrát*, vyhraju	gewinnen (pf.)	Index Verben
vyhrávat, vahrávám	gewinnen (impf.)	Index Verben
{\color{blue}východ}	1. Osten, 2. Ausgang, 3. Sonnenuntergang	Index
{\color{green}východiště}	Ausgangspunkt	Index
východní	Ost-	Index
vykoupat* se, vykoupu se	baden (pf.)	Index Verben
{\color{blue}výlet}	Ausflug	Index
vylézt*, vylezu na skály	klettern (Felsen) (pf.)	Index
vylít*, vyliju	ausgießen, ausschütten (pf.)	Index Verben
vyluštit, vyluštím křížovku	ein Kreuzworträtsel machen (pf.)	Index
vyluxovat, vyluxuju	staubsaugen (pf.)	Index Verben
vymalovat, vymaluju	malern (Wohnung) (pf.)	Index Verben
vypadat, vypadám	aussehen (impf.)	Index Verben
vypít*, vypiju	austrinken (pf.)	Index Verben
vyprat*, vyperu oblečení	waschen (Kleidung) (pf.)	Index Verben
vyřídit, vyřídím	ausrichten (Grüße) (pf.)	Index Verben
vyřizovat, vyřizuju	ausrichten (Grüße) (impf.)	Index Verben
vyslovovat, vyslovuju	aussprechen (impf.)	Index Verben
vyslovit, vyslovím	aussprechen (pf.)	Index Verben
výslovnost	Aussprache	Index
vysoká škola	Hochschule	Index
{\color{red}výstava}	Ausstellung	Index
vysvětlit, vysvětlím	erkären (pf.)	Index Verben
vysvětlovat, vysvětluju	erklären (impf.)	Index Verben
vyžehlit, vyžehlím	bügeln (pf.)	Index Verben
{\color{blue}vzduch}	Luft	Index
vzhledem k	in Anbetracht dessen, mit Bezug auf, unter Berücksichtigung von, angesichts	Index
vzít* si, vezmu si	nehmen (auch i.S. von heiraten) (pf.)	Index Verben
vzít, vezmu	nehmen (pf.)	Index Verben
{\color{blue}vzkaz} / {\color{red}zpráva}	Nachricht	Index
{\color{blue}vztek}, {\color{red}zlost}	Wut, Ärger (2x)	Index
z domova	von zu Hause	Index
za (4x)	1. hinter, 2. in (zwei Tagen), 3. für, anstelle von, 4. per	Index
zabíjet, zabíjím	umbringen, erschlagen (impf.)	Index Verben
zabít*, zabiju	umbringen, erschlagen (pf.)	Index Verben
zacvičit si, zacvičím si	üben, Gymnastik machen (pf.)	Index Verben
začínat, začínám	beginnen, anfangen (impf.)	Index Verben
začít*, začnu	beginnen, anfangen (pf.)	Index Verben
{\color{blue}záda} (pl.)	Rücken	Index
zadem	durch den hinteren Teil	Index
{\color{red}zahrada}	Garten	Index
zahrát*, zahraju	spielen	Index
zahřmít*, zahřmím	donnern (pf.)	Index Verben
{\color{blue}záchod}	Toilette/WC (nicht Frendwort)	Index
zakládat, zakládám	gründen (impf.)	Index Verben
základní škola	Grundschule (1.-9. Klasse)	Index
založit, založím	gründen (pf.)	Index Verben
zalyžovat si, zalyžuju si	Ski laufen (pf.)	Index Verben
{\color{green}zaměstnání}	Arbeit, Anstellung	Index
zamíchat, zamíchám	mischen (pf.)	Index Verben
zamilovat se, zamiluju se	sich verlieben (pf.)	Index Verben
zamilovávat se, zamilovávat se	sich verlieben (impf.)	Index Verben
{\color{blue}západ}	1. Westen 2. Sonnenuntergang	Index
západní	westlich, West-	Index
zaplatit, zaplatím	bezahlen, zahlen (pf.)	Index Verben
zaplavat* si, zaplavu si	schwimmen (pf.)	Index Verben
zapomínat, zapomínám	vergessen (impf.)	Index Verben
zapomnětlivý	vergesslich	Index
zase	wieder, erneut	Index
zasmát* se, zasměju se	lachen (pf.)	Index Verben
zasnoubit se, zasnoubím se	sich verloben (pf.)	Index Verben
zasnubovat se, zasnubuju se	sich verloben (impf.)	Index Verben
{\color{red}zastávka}	Haltestelle (Straßenbahn, Bus)	Index
zatancovat si, zatancuju si	tanzen (pf.)	Index Verben
zataženo	bedeckt (Wetter)	Index
zatelefonovat, zatelefonuju	telefonieren (pf.)	Index Verben
zatím	bis jetzt	Index
zatímco	während (nicht zeitl.)	Index
{\color{green}zav}{\color{green}azadlo}	Gepäck	Index
zavolat, zavolám	anrufen (pf.)	Index Verben
Zavolej! Zavolejte!	Ruf an! Ruft/Rufen Sie an!	Index
{\color{blue}záznamník}	Anrufbeantworter	Index
zazpívat, zazpívám	singen (pf.)	Index Verben
zazvonit, zazvoním	klingeln (pf.)	Index Verben
{\color{blue}zážit\uline{e}k}	Erlebnis	Index
zdola	von unten	Index
zdvořilý	höflich	Index
zelený	grün	Index
{\color{green}zelí}	Kohl, Kraut	Index
{\color{red}země}	1.Land (Staat), 2. Boden	Index
{\color{red}Země}	die Erde	Index
zemřít*, zemřu	sterben (pf.) (Duplikat)	Index Verben
zepředu	von vorn	Index
zeptat se, zeptám se	fragen (pf.)	Index Verben
zevnitř	von drinnen, innen	Index
zezadu	von hinten	Index
zkotrolovat, zkontroluju	kontrollieren (pf.)	Index Verben
{\color{red}zkouška}	Prüfung	Index
Zkus to! Zkuste to!	Versuch es! Versucht es!	Index
{\color{red}zkušenost}	Erfahrung	Index
Zlaté stránky	Gelbe Seiten	Index
zleva	von links	Index
zlý	schlimm, böse	Index
{\color{blue}zmat\uline{e}k}	Chaos, Unordnung	Index
zmixovat, zmixuju	mixen (impf.) (Duplikat)	Index Verben
znamenat, znamená	bedeuten (impf.)	Index Verben
znát, znám	kennen (impf.)	Index Verben
zodpovědný	verantwortlich	Index
zpívat, zpívám	singen (impf.)	Index Verben
zprava	von rechts	Index
zprostředku	aus, von der Mittel	Index
ztrácet, ztrácím	verlieren (impf.)	Index Verben
ztratit, ztratím	verlieren (pf.)	Index Verben
{\color{blue}zub}	Zahn	Index
zvát*, zvu	einladen (impf.)	Index Verben
zvědavý	neugierig	Index
zvenku	von draußen, außen	Index
zvlášť	extra, getrennt	Index
zvonit, zvoním	klingeln (impf.)	Index Verben
žádat, žádám	beantragen, bitten (offiziell) (impf.)	Index Verben
žádný (adj.)	kein (Duplikat)	Index
{\color{blue}žalud\uline{e}k}	Magen	Index
žehlit, žehlím	bügeln (impf.)	Index Verben
ženatý	verheiratet (Mann)	Index
ženit se, žením se	heiraten (Mann) (impf.)	Index Verben
žít*, žiju	leben (impf.)	Index Verben
{\color{blue}život}	Leben	Index
životní {\color{blue}styl}	Lebensstil	Index
{\color{red}žízeň}	Durst	Index